short domain	long domain	label
nsvrc	nsvrc.org	stat,org
nutritionfacts	nutritionfacts.org	db
esquire	esquire.com	news
walmart	walmart.com	o
nationalinterest	nationalinterest.org	news
migrationpolicy	migrationpolicy.org	db,org
cbssports	cbssports.com	db
support	support.google.com	o
quran	quran.com	source
socialworkers	socialworkers.org	org
research	research.upjohn.org	org,db
khanacademy	khanacademy.org	pedia
bleacherreport	bleacherreport.com	news
injuryprevention	injuryprevention.bmj.com	sci
businessweek	businessweek.com	news
turner	i2.cdn.turner.com	o
encyclopedia	encyclopedia.com	pedia
inc	inc.com	news
observer	observer.com	news
rasmussenreports	rasmussenreports.com	db
mediaite	mediaite.com	news
thediplomat	thediplomat.com	news
iihs	iihs.org	db
oregonlive	gov.oregonlive.com	news,govt
pewtrusts	pewtrusts.org	sci
annualreviews	annualreviews.org	sci
mobile	mobile.abc.net.au	news
naacp	naacp.org	org,db
cell	cell.com	sci
nationalpriorities	nationalpriorities.org	org,stat
gapminder	gapminder.org	db
disastercenter	disastercenter.com	db
business	business.time.com	news
ushmm	ushmm.org	o
avoiceformen	avoiceformen.com	o
smartasset	smartasset.com	-1
wlmht	wlmht.nhs.uk	-1
microsoft	research.microsoft.com	-1
vox-cdn	cdn2.vox-cdn.com	-1
chronicle	chronicle.com	-1
boingboing	boingboing.net	-1
fanfiction	fanfiction.net	-1
gatherer	gatherer.wizards.com	-1
io9	io9.com	-1
econlog	econlog.econlib.org	-1
canada	canada.ca	-1
voxeu	voxeu.org	-1
change	change.org	-1
vpc	vpc.org	-1
wnd	wnd.com	-1
sports	sports.espn.go.com	-1
cosmopolitan	cosmopolitan.com	-1
healthcare	healthcare.findlaw.com	-1
smallbusiness	smallbusiness.chron.com	-1
staticflickr	farm3.staticflickr.com	-1
rottentomatoes	rottentomatoes.com	-1
thoughtcatalog	thoughtcatalog.com	-1
ahajournals	circ.ahajournals.org	-1
aap	aap.org	-1
edweek	edweek.org	-1
twimg	pbs.twimg.com	-1
pewhispanic	pewhispanic.org	-1
usgovernmentspending	usgovernmentspending.com	-1
yesmeansyesblog	yesmeansyesblog.wordpress.com	-1
charitynavigator	charitynavigator.org	-1
governing	governing.com	-1
sbnation	sbnation.com	-1
aeon	aeon.co	-1
glassdoor	glassdoor.com	-1
economicshelp	economicshelp.org	-1
boston	boston.com	-1
ranker	ranker.com	-1
ebay	ebay.com	-1
listverse	listverse.com	-1
constitutioncenter	blog.constitutioncenter.org	-1
escapistmagazine	escapistmagazine.com	-1
torontosun	storage.torontosun.com	-1
ncaa	fs.ncaa.org	-1
hollywoodreporter	hollywoodreporter.com	-1
advisorperspectives	advisorperspectives.com	-1
royalsocietypublishing	royalsocietypublishing.org	-1
ohchr	ohchr.org	-1
catholic	catholic.org	-1
themarshallproject	themarshallproject.org	-1
dmv	dmv.org	-1
discovery	dsc.discovery.com	-1
bit	bit.ly	-1
quandl	quandl.com	-1
opinionator	opinionator.blogs.nytimes.com	-1
jewishvirtuallibrary	jewishvirtuallibrary.org	-1
scotusblog	scotusblog.com	-1
puu	puu.sh	-1
verywellmind	verywellmind.com	-1
tampabay	tampabay.com	-1
wikisource	en.wikisource.org	-1
polygon	polygon.com	-1
lifehacker	lifehacker.com	-1
militarytimes	militarytimes.com	-1
currentaffairs	static.currentaffairs.org	-1
irishtimes	irishtimes.com	-1
plosone	plosone.org	-1
dailymotion	dailymotion.com	-1
upi	upi.com	-1
utoronto	sds.utoronto.ca	-1
upworthy	upworthy.com	-1
trends	trends.google.com	-1
hyperboleandahalf	hyperboleandahalf.blogspot.com	-1
afsp	afsp.org	-1
spectator	spectator.org	-1
biomedcentral	jehse.biomedcentral.com	-1
grist	grist.org	-1
bing	bing.com	-1
legalmatch	lawblog.legalmatch.com	-1
unodc	unodc.org	-1
boxofficemojo	boxofficemojo.com	-1
oecdbetterlifeindex	oecdbetterlifeindex.org	-1
livestrong	livestrong.com	-1
collegeboard	sat.collegeboard.org	-1
harrypotter	harrypotter.wikia.com	-1
elections	elections.nbcnews.com	-1
dqydj	dqydj.com	-1
zillow	zillow.com	-1
worldatlas	worldatlas.com	-1
sciencebasedmedicine	sciencebasedmedicine.org	-1
mappingpoliceviolence	mappingpoliceviolence.org	-1
memidex	memidex.com	-1
publishing	assets.publishing.service.gov.uk	-1
nami	nami.org	-1
deviantart	deviantart.com	-1
menshealth	menshealth.com	-1
japantimes	japantimes.co.jp	-1
tylervigen	tylervigen.com	-1
thealternativehypothesis	thealternativehypothesis.org	-1
translate	translate.google.se	-1
ftp	ftp.iza.org	-1
fusion	fusion.net	-1
world	world.time.com	-1
marketplace	marketplace.firefox.com	-1
fullfact	fullfact.org	-1
bankrate	bankrate.com	-1
aspca	aspca.org	-1
definitions	definitions.uslegal.com	-1
startribune	m.startribune.com	-1
theblog	theblog.okcupid.com	-1
kinja-img	i.kinja-img.com	-1
baltimoresun	articles.baltimoresun.com	-1
freebeacon	freebeacon.com	-1
the-scientist	the-scientist.com	-1
libcom	libcom.org	-1
engadget	engadget.com	-1
lawcomic	lawcomic.net	-1
humanesociety	humanesociety.org	-1
aamc	aamc.org	-1
study	study.com	-1
timesofindia	timesofindia.indiatimes.com	-1
circumcision	circumcision.org	-1
unicef	unicef.org	-1
hamiltonproject	hamiltonproject.org	-1
thetrace	thetrace.org	-1
morningconsult	morningconsult.com	-1
christianpost	christianpost.com	-1
policeone	policeone.com	-1
parl	parl.ca	-1
shrm	shrm.org	-1
channel4	channel4.com	-1
iea	iea.org	-1
billboard	billboard.com	-1
world-nuclear	world-nuclear.org	-1
deadspin	deadspin.com	-1
pgpf	pgpf.org	-1
gatestoneinstitute	gatestoneinstitute.org	-1
basketball-reference	basketball-reference.com	-1
digitaltrends	icdn6.digitaltrends.com	-1
genetics	genetics.thetech.org	-1
thetruthaboutguns	thetruthaboutguns.com	-1
priceonomics	blog.priceonomics.com	-1
realclearscience	realclearscience.com	-1
kqed	kqed.org	-1
ign	ign.com	-1
washingtonsblog	washingtonsblog.com	-1
theanarchistlibrary	theanarchistlibrary.org	-1
marvel	marvel.wikia.com	-1
prb	prb.org	-1
english	english.pravda.ru	-1
quillette	quillette.com	-1
itspronouncedmetrosexual	itspronouncedmetrosexual.com	-1
intelligence	intelligence.org	-1
inquisitr	inquisitr.com	-1
ruqqus	ruqqus.com	-1
drugpolicy	drugpolicy.org	-1
extremetech	extremetech.com	-1
miamiherald	miamiherald.com	-1
rsf	rsf.org	-1
dsm5	dsm5.org	-1
carbonbrief	carbonbrief.org	-1
cepr	cepr.net	-1
guardian	guardian.co.uk	-1
smartgunlaws	smartgunlaws.org	-1
squarespace	static1.squarespace.com	-1
thetimes	thetimes.co.uk	-1
americanthinker	americanthinker.com	-1
immigrationpolicy	immigrationpolicy.org	-1
imgflip	i.imgflip.com	-1
gotquestions	gotquestions.org	-1
amp	amp.cnn.com	-1
wbur	wbur.org	-1
azcentral	archive.azcentral.com	-1
wol	wol.iza.org	-1
gwern	gwern.net	-1
beckershospitalreview	beckershospitalreview.com	-1
visualcapitalist	visualcapitalist.com	-1
monsanto	monsanto.com	-1
vaccines	vaccines.procon.org	-1
economix	economix.blogs.nytimes.com	-1
about	about.usps.com	-1
c-span	c-span.org	-1
transadvocate	transadvocate.com	-1
stack	i.stack.imgur.com	-1
timeshighereducation	timeshighereducation.com	-1
spectrum	spectrum.ieee.org	-1
salary	salary.com	-1
ama-assn	ama-assn.org	-1
complex	complex.com	-1
macleans	macleans.ca	-1
myanimelist	myanimelist.net	-1
econtalk	econtalk.org	-1
nyclu	nyclu.org	-1
electology	electology.github.io	-1
dailysignal	dailysignal.com	-1
kickstarter	kickstarter.com	-1
toronto	toronto.ctvnews.ca	-1
arrow-journal	arrow-journal.org	-1
steampowered	store.steampowered.com	-1
theoatmeal	theoatmeal.com	-1
streamable	streamable.com	-1
consumerreports	consumerreports.org	-1
feministing	feministing.com	-1
informationisbeautiful	informationisbeautiful.net	-1
thefirearmblog	thefirearmblog.com	-1
thestranger	thestranger.com	-1
heavy	heavy.com	-1
isidewith	isidewith.com	-1
ajc	ajc.com	-1
itep	itep.org	-1
psychiatrictimes	psychiatrictimes.com	-1
ohrc	ohrc.on.ca	-1
criminal	criminal.findlaw.com	-1
prri	prri.org	-1
teenvogue	teenvogue.com	-1
netflix	dvd.netflix.com	-1
finaid	finaid.org	-1
treehugger	treehugger.com	-1
foreignaffairs	foreignaffairs.com	-1
truth-out	truth-out.org	-1
dogsbite	blog.dogsbite.org	-1
poetryfoundation	poetryfoundation.org	-1
prosperity	prosperity.com	-1
dietitians	dietitians.ca	-1
assets2	assets2.hrc.org	-1
ncase	ncase.me	-1
tcf	tcf.org	-1
journalism	journalism.org	-1
yourveganfallacyis	yourveganfallacyis.com	-1
civilrights	civilrights.org	-1
consumerist	consumerist.com	-1
babycenter	babycenter.com	-1
wallethub	wallethub.com	-1
city-journal	city-journal.org	-1
caranddriver	caranddriver.com	-1
freethoughtblogs	freethoughtblogs.com	-1
library	library.college.police.uk	-1
minneapolisfed	minneapolisfed.org	-1
vocativ	vocativ.com	-1
lesacreduprintemps19	lesacreduprintemps19.files.wordpress.com	-1
vulture	vulture.com	-1
newegg	newegg.com	-1
usafacts	usafacts.org	-1
gop	gop.com	-1
gyazo	i.gyazo.com	-1
sli	i.sli.mg	-1
bjsm	bjsm.bmj.com	-1
suntimes	chicago.suntimes.com	-1
jsonline	archive.jsonline.com	-1
cleveland	cleveland.com	-1
zerohedge	zerohedge.com	-1
oxfordlearnersdictionaries	oxfordlearnersdictionaries.com	-1
deathpenalty	deathpenalty.org	-1
wikiislam	wikiislam.net	-1
johnstonsarchive	johnstonsarchive.net	-1
theamericanconservative	theamericanconservative.com	-1
transparency	transparency.org	-1
greenpeace	greenpeace.org	-1
corestandards	corestandards.org	-1
alamy	n7.alamy.com	-1
philly	philly.com	-1
bible	viz.bible	-1
amnestyusa	amnestyusa.org	-1
dilbert	dilbert.com	-1
civilwar	civilwar.org	-1
itunes	itunes.apple.com	-1
wizards	wizards.com	-1
marripedia	marripedia.org	-1
krugman	krugman.blogs.nytimes.com	-1
collinsdictionary	collinsdictionary.com	-1
nerdwallet	nerdwallet.com	-1
vegansociety	vegansociety.com	-1
consad	consad.com	-1
what-if	what-if.xkcd.com	-1
projects	projects.thestar.com	-1
frontpagemag	frontpagemag.com	-1
zdnet	zdnet.com	-1
cjr	cjr.org	-1
wpath	wpath.org	-1
jme	jme.bmj.com	-1
investors	investors.com	-1
refinery29	refinery29.com	-1
nizkor	nizkor.org	-1
them	them.us	-1
opendemocracy	opendemocracy.net	-1
nation	nation.co.ke	-1
aarp	aarp.org	-1
pinterest	pinterest.se	-1
legislation	legislation.govt.nz	-1
gamasutra	gamasutra.com	-1
object	object.cato.org	-1
biblestudytools	biblestudytools.com	-1
gamespot	gamespot.com	-1
nationaljournal	nationaljournal.com	-1
comicvine	comicvine.com	-1
medicine	medicine.ucalgary.ca	-1
dtic	dtic.mil	-1
unesco	unesco.org	-1
physiology	physiology.org	-1
liebertpub	online.liebertpub.com	-1
gatesfoundation	gatesfoundation.org	-1
unz	unz.com	-1
tinypic	tinypic.com	-1
boredpanda	boredpanda.com	-1
infowars	infowars.com	-1
healthychildren	healthychildren.org	-1
americanpregnancy	americanpregnancy.org	-1
existentialcomics	existentialcomics.com	-1
datacenter	datacenter.kidscount.org	-1
parliament	parliament.uk	-1
city-data	city-data.com	-1
bloombergview	bloombergview.com	-1
mlive	mlive.com	-1
adnausi	adnausi.ca	-1
acsh	acsh.org	-1
billmoyers	billmoyers.com	-1
ncpa	ncpa.org	-1
amren	amren.com	-1
podcasts	podcasts.apple.com	-1
politicususa	politicususa.com	-1
americanimmigrationcouncil	americanimmigrationcouncil.org	-1
youarenotsosmart	youarenotsosmart.com	-1
yimg	s.yimg.com	-1
www-m	www-m.cnn.com	-1
aynrandlexicon	aynrandlexicon.com	-1
straightdope	straightdope.com	-1
nraila	nraila.org	-1
teni	teni.ie	-1
scc-csc	scc-csc.lexum.com	-1
panda	wwf.panda.org	-1
entrepreneur	entrepreneur.com	-1
gunviolencearchive	gunviolencearchive.org	-1
forward	blogs.forward.com	-1
nextbigfuture	nextbigfuture.com	-1
stats	stats.oecd.org	-1
sacbee	sacbee.com	-1
childtrends	childtrends.org	-1
metacritic	metacritic.com	-1
intelligencesquaredus	intelligencesquaredus.org	-1
legalzoom	legalzoom.com	-1
blogs-images	blogs-images.forbes.com	-1
wikia	lotr.wikia.com	-1
nutritiondata	nutritiondata.self.com	-1
freep	freep.com	-1
feelthebern	feelthebern.org	-1
france24	france24.com	-1
animalvisuals	animalvisuals.org	-1
poverty	poverty.org.uk	-1
indeed	indeed.com	-1
autismresearchcentre	docs.autismresearchcentre.com	-1
weeklystandard	weeklystandard.com	-1
thefiscaltimes	thefiscaltimes.com	-1
ppic	ppic.org	-1
abajournal	abajournal.com	-1
washingtonmonthly	washingtonmonthly.com	-1
freedomhouse	freedomhouse.org	-1
ac360	ac360.blogs.cnn.com	-1
feedingamerica	feedingamerica.org	-1
redstate	redstate.com	-1
deadline	deadline.com	-1
cleantechnica	cleantechnica.com	-1
firstlook	firstlook.org	-1
redditblog	redditblog.com	-1
ets	ets.org	-1
stltoday	stltoday.com	-1
linkedin	linkedin.com	-1
thefreethoughtproject	thefreethoughtproject.com	-1
mercatus	mercatus.org	-1
econstor	econstor.eu	-1
avma	avma.org	-1
cowspiracy	cowspiracy.com	-1
counterpunch	counterpunch.org	-1
memory-alpha	en.memory-alpha.org	-1
elitedaily	elitedaily.com	-1
oecd-ilibrary	oecd-ilibrary.org	-1
army	army.mil	-1
medicinenet	medicinenet.com	-1
civitas	civitas.org.uk	-1
stripes	stripes.com	-1
penny-arcade	penny-arcade.com	-1
thejournal	thejournal.ie	-1
globalrichlist	globalrichlist.com	-1
thewire	thewire.com	-1
hotair	hotair.com	-1
acog	acog.org	-1
catalyst	catalyst.org	-1
vocabulary	vocabulary.com	-1
represent	represent.us	-1
randalolson	randalolson.com	-1
marginalrevolution	marginalrevolution.com	-1
endocrine	press.endocrine.org	-1
ivn	ivn.us	-1
justfacts	justfacts.com	-1
dreamstime	thumbs.dreamstime.com	-1
ilo	ilo.org	-1
dancarlin	dancarlin.com	-1
ae911truth	ae911truth.org	-1
religioustolerance	religioustolerance.org	-1
medical-dictionary	medical-dictionary.thefreedictionary.com	-1
nrdc	nrdc.org	-1
pcworld	pcworld.com	-1
mitpressjournals	mitpressjournals.org	-1
psych	www2.psych.ubc.ca	-1
hpmor	hpmor.com	-1
avclub	news.avclub.com	-1
therichest	therichest.com	-1
electproject	electproject.org	-1
flickr	flickr.com	-1
medpagetoday	medpagetoday.com	-1
aaafoundation	aaafoundation.org	-1
torrentfreak	torrentfreak.com	-1
bizjournals	bizjournals.com	-1
siteresources	siteresources.worldbank.org	-1
philanthropyroundtable	philanthropyroundtable.org	-1
criminaldefenselawyer	criminaldefenselawyer.com	-1
americanaddictioncenters	americanaddictioncenters.org	-1
drugwarfacts	drugwarfacts.org	-1
alexa	alexa.com	-1
addons	addons.opera.com	-1
adguard	adguard.com	-1
graphics8	graphics8.nytimes.com	-1
verywellfamily	verywellfamily.com	-1
fairus	fairus.org	-1
seriouseats	slice.seriouseats.com	-1
lazard	lazard.com	-1
joincampaignzero	joincampaignzero.org	-1
ncadv	ncadv.org	-1
worldhunger	worldhunger.org	-1
dropbox	dropbox.com	-1
eater	eater.com	-1
livejournal	bradhicks.livejournal.com	-1
stackoverflow	stackoverflow.com	-1
bartleby	bartleby.com	-1
courier-journal	courier-journal.com	-1
predictit	predictit.org	-1
budget	budget.gov.ie	-1
cba	cba.org	-1
sbs	sbs.com.au	-1
climatecommunication	climatecommunication.org	-1
mnn	mnn.com	-1
kjplanet	kjplanet.com	-1
rense	rense.com	-1
diffen	diffen.com	-1
lds	lds.org	-1
usccb	usccb.org	-1
mcgill	mcgill.ca	-1
givingwhatwecan	givingwhatwecan.org	-1
now	now.org	-1
emilkirkegaard	emilkirkegaard.dk	-1
lawfareblog	lawfareblog.com	-1
gimletmedia	gimletmedia.com	-1
ibb	ibb.co	-1
iucnredlist	iucnredlist.org	-1
cdn	cdn.cnn.com	-1
worldhappiness	worldhappiness.report	-1
utilitarian	utilitarian.net	-1
bgr	bgr.com	-1
newyorkfed	newyorkfed.org	-1
globalissues	globalissues.org	-1
crfb	crfb.org	-1
maps	maps.app.goo.gl	-1
thehindu	thehindu.com	-1
equal	equal.vote	-1
monticello	monticello.org	-1
schneier	schneier.com	-1
coursera	coursera.org	-1
allthatsinteresting	allthatsinteresting.com	-1
theage	theage.com.au	-1
carm	carm.org	-1
screenrant	screenrant.com	-1
prod-cdn-static	prod-cdn-static.gop.com	-1
nobelprize	nobelprize.org	-1
sparknotes	sparknotes.com	-1
economictimes	economictimes.indiatimes.com	-1
ironchariots	wiki.ironchariots.org	-1
xojane	xojane.com	-1
pro-football-reference	pro-football-reference.com	-1
abort73	abort73.com	-1
erowid	erowid.org	-1
khn	khn.org	-1
historyofvaccines	historyofvaccines.org	-1
answersingenesis	answersingenesis.org	-1
ceoworld	ceoworld.biz	-1
allrecipes	allrecipes.com	-1
mdpi	mdpi.com	-1
postcog	postcog.ucd.ie	-1
foxbusiness	foxbusiness.com	-1
boundless	boundless.com	-1
diabetesjournals	clinical.diabetesjournals.org	-1
daa	daa.asn.au	-1
frbsf	frbsf.org	-1
parents	parents.com	-1
conservapedia	conservapedia.com	-1
fcmconference	fcmconference.org	-1
stuff	i.stuff.co.nz	-1
msmagazine	msmagazine.com	-1
aph	aph.gov.au	-1
pics	pics.me.me	-1
oed	oed.com	-1
lgbtqnation	bilerico.lgbtqnation.com	-1
futurism	futurism.com	-1
nickbostrom	nickbostrom.com	-1
oxfam	oxfam.org	-1
jaapl	jaapl.org	-1
motorists	motorists.org	-1
orlandosentinel	orlandosentinel.com	-1
nationalparentsorganization	nationalparentsorganization.org	-1
azlyrics	azlyrics.com	-1
ichef	ichef.bbci.co.uk	-1
guns	guns.com	-1
pcgamer	pcgamer.com	-1
gunfacts	gunfacts.info	-1
pastemagazine	pastemagazine.com	-1
eprints	eprints.lse.ac.uk	-1
vignette	vignette.wikia.nocookie.net	-1
cihi	cihi.ca	-1
lawcenter	lawcenter.giffords.org	-1
parenting	parenting.com	-1
hathitrust	catalog.hathitrust.org	-1
redditmedia	b.thumbs.redditmedia.com	-1
verywellhealth	verywellhealth.com	-1
demos	demos.org	-1
harpers	harpers.org	-1
piketty	piketty.pse.ens.fr	-1
venturebeat	venturebeat.com	-1
thesaurus	thesaurus.com	-1
raikoth	raikoth.net	-1
genocidewatch	genocidewatch.org	-1
acpeds	acpeds.org	-1
deanradin	deanradin.com	-1
harvardmagazine	harvardmagazine.com	-1
goodmenproject	goodmenproject.com	-1
bigstory	bigstory.ap.org	-1
sfchronicle	sfchronicle.com	-1
educationnext	educationnext.org	-1
everydayhealth	everydayhealth.com	-1
onecle	law.onecle.com	-1
weather	weather.com	-1
mcclatchydc	mcclatchydc.com	-1
standard	standard.net	-1
multpl	multpl.com	-1
amjmed	amjmed.com	-1
askmen	askmen.com	-1
iwpr	iwpr.org	-1
postimg	s23.postimg.org	-1
vignette3	vignette3.wikia.nocookie.net	-1
bostonreview	bostonreview.net	-1
heartandstroke	heartandstroke.com	-1
apsa	apsa.org	-1
wnyc	wnyc.org	-1
outsports	outsports.com	-1
acpjournals	acpjournals.org	-1
glamour	glamour.com	-1
thecanadianencyclopedia	thecanadianencyclopedia.ca	-1
skeptoid	skeptoid.com	-1
wattsupwiththat	wattsupwiththat.com	-1
sourcewatch	sourcewatch.org	-1
escholarship	escholarship.org	-1
heraldtribune	projects.heraldtribune.com	-1
justsecurity	justsecurity.org	-1
ibiblio	ibiblio.org	-1
ssl-images-amazon	images-na.ssl-images-amazon.com	-1
nationalhomeless	nationalhomeless.org	-1
onegreenplanet	onegreenplanet.org	-1
ontario	ontario.ca	-1
vancouversun	blogs.vancouversun.com	-1
statelaws	statelaws.findlaw.com	-1
worldpublicopinion	worldpublicopinion.net	-1
lewrockwell	archive.lewrockwell.com	-1
stitcher	stitcher.com	-1
wikibooks	en.wikibooks.org	-1
newadvent	newadvent.org	-1
previews	previews.123rf.com	-1
slidesharecdn	image.slidesharecdn.com	-1
desmogblog	desmogblog.com	-1
policymic	policymic.com	-1
jalopnik	jalopnik.com	-1
examine	examine.com	-1
publications	publications.parliament.uk	-1
everytownresearch	everytownresearch.org	-1
chabad	chabad.org	-1
openborders	openborders.info	-1
99percentinvisible	99percentinvisible.org	-1
islamqa	islamqa.info	-1
rdcu	rdcu.be	-1
thegrayzone	thegrayzone.com	-1
tobaccocontrol	tobaccocontrol.bmj.com	-1
nautil	nautil.us	-1
heinonline	heinonline.org	-1
feministcurrent	feministcurrent.com	-1
towardsdatascience	towardsdatascience.com	-1
kingjamesbibleonline	kingjamesbibleonline.org	-1
freerepublic	freerepublic.com	-1
culturalcognition	culturalcognition.net	-1
core	core.ac.uk	-1
fair	fair.org	-1
theaustralian	theaustralian.com.au	-1
thetaskforce	thetaskforce.org	-1
tippingresearch	tippingresearch.com	-1
statesman	statesman.com	-1
healio	healio.com	-1
nationalpopularvote	nationalpopularvote.com	-1
nyti	nyti.ms	-1
nhmrc	nhmrc.gov.au	-1
helpguide	helpguide.org	-1
simulation-argument	simulation-argument.com	-1
nola	nola.com	-1
westeros	awoiaf.westeros.org	-1
topuniversities	topuniversities.com	-1
psychohistory	psychohistory.com	-1
80000hours	80000hours.org	-1
lumenlearning	courses.lumenlearning.com	-1
businesswire	businesswire.com	-1
floridapolitics	floridapolitics.com	-1
eurogamer	eurogamer.net	-1
computerworld	computerworld.com	-1
shrinkthatfootprint	shrinkthatfootprint.com	-1
static01	static01.nyt.com	-1
medicalxpress	medicalxpress.com	-1
streetsblog	usa.streetsblog.org	-1
preview	preview.redd.it	-1
rollcall	rollcall.com	-1
arcgis	arcgis.com	-1
valuepenguin	valuepenguin.com	-1
self	self.com	-1
americannutritionassociation	americannutritionassociation.org	-1
biography	biography.com	-1
science20	science20.com	-1
dsausa	dsausa.org	-1
publicintegrity	publicintegrity.org	-1
borgenproject	borgenproject.org	-1
indiewire	blogs.indiewire.com	-1
bloodyelbow	bloodyelbow.com	-1
broadly	broadly.vice.com	-1
thewrap	thewrap.com	-1
redcrossblood	redcrossblood.org	-1
timwise	timwise.org	-1
ushistory	ushistory.org	-1
beliefnet	beliefnet.com	-1
brainyquote	brainyquote.com	-1
thedailyshow	thedailyshow.cc.com	-1
epionline	epionline.org	-1
libertarianism	libertarianism.org	-1
pcrm	pcrm.org	-1
cancerresearchuk	cancerresearchuk.org	-1
paulgraham	paulgraham.com	-1
richmond	richmond.com	-1
kinseyinstitute	kinseyinstitute.org	-1
daviddfriedman	daviddfriedman.com	-1
journalofethics	journalofethics.ama-assn.org	-1
charitywatch	charitywatch.org	-1
alarabiya	english.alarabiya.net	-1
cic	cic.gc.ca	-1
co	g.co	-1
allsides	allsides.com	-1
theincidentaleconomist	theincidentaleconomist.com	-1
thecollegefix	thecollegefix.com	-1
mentalhealth	mentalhealth.org.uk	-1
gettyimages	media.gettyimages.com	-1
metacpan	metacpan.org	-1
embryology	embryology.ch	-1
external-content	external-content.duckduckgo.com	-1
mattbruenig	mattbruenig.com	-1
ninehundred	ninehundred.net	-1
inflationdata	inflationdata.com	-1
manhattan-institute	manhattan-institute.org	-1
tabletmag	tabletmag.com	-1
swissinfo	swissinfo.ch	-1
oddee	oddee.com	-1
autismspeaks	autismspeaks.org	-1
giphy	giphy.com	-1
publicpolicypolling	publicpolicypolling.com	-1
rankingsandreviews	grad-schools.usnews.rankingsandreviews.com	-1
nbcsandiego	nbcsandiego.com	-1
quoteinvestigator	quoteinvestigator.com	-1
bra	bra.se	-1
gmoanswers	gmoanswers.com	-1
ingentaconnect	ingentaconnect.com	-1
unfccc	unfccc.int	-1
cen	cen.acs.org	-1
usmagazine	usmagazine.com	-1
pnhp	pnhp.org	-1
gnu	gnu.org	-1
cinemablend	cinemablend.com	-1
imgs	imgs.xkcd.com	-1
americamagazine	americamagazine.org	-1
ruger	ruger.com	-1
buckeyefirearms	buckeyefirearms.org	-1
debate	debate.org	-1
yudkowsky	yudkowsky.net	-1
iq-research	iq-research.info	-1
volokh	volokh.com	-1
sciencenordic	sciencenordic.com	-1
ipsos	ipsos.com	-1
changeaview	changeaview.com	-1
cra-arc	cra-arc.gc.ca	-1
atlantablackstar	atlantablackstar.com	-1
hoover	hoover.org	-1
mentalhealthdaily	mentalhealthdaily.com	-1
washingtoncitypaper	washingtoncitypaper.com	-1
ycharts	ycharts.com	-1
feminist	feminist.com	-1
ijreview	ijreview.com	-1
cdn-images-1	cdn-images-1.medium.com	-1
dosomething	dosomething.org	-1
worldwatch	worldwatch.org	-1
melbourneinstitute	melbourneinstitute.com	-1
responsibility	responsibility.org	-1
minnpost	minnpost.com	-1
statutes	statutes.legis.state.tx.us	-1
usinflationcalculator	usinflationcalculator.com	-1
sun-sentinel	sun-sentinel.com	-1
theregister	theregister.co.uk	-1
courtlistener	courtlistener.com	-1
latimesblogs	latimesblogs.latimes.com	-1
advocatesforyouth	advocatesforyouth.org	-1
openargs	openargs.com	-1
tmz	tmz.com	-1
indystar	indystar.com	-1
equality-of-opportunity	equality-of-opportunity.org	-1
openbible	openbible.info	-1
documents	documents.worldbank.org	-1
daily	daily.jstor.org	-1
stillmed	stillmed.olympic.org	-1
reasonablefaith	reasonablefaith.org	-1
armytimes	armytimes.com	-1
abc7	abc7.com	-1
apadivisions	apadivisions.org	-1
csgjusticecenter	csgjusticecenter.org	-1
nationalarchives	webarchive.nationalarchives.gov.uk	-1
gotopless	gotopless.org	-1
adweek	adweek.com	-1
cgpgrey	cgpgrey.com	-1
thenewamerican	thenewamerican.com	-1
theamericanmuslim	theamericanmuslim.org	-1
images-amazon	ecx.images-amazon.com	-1
globalcitizen	globalcitizen.org	-1
logicalfallacies	logicalfallacies.org	-1
juancole	juancole.com	-1
the-numbers	the-numbers.com	-1
cbs	cbs.gov.il	-1
gothamist	gothamist.com	-1
nbcnewyork	nbcnewyork.com	-1
retractionwatch	retractionwatch.com	-1
healthyplace	healthyplace.com	-1
psypost	psypost.org	-1
pjmedia	pjmedia.com	news
rferl	rferl.org	-1
timeinc	img2-3.timeinc.net	-1
lung	lung.org	-1
cmaj	cmaj.ca	-1
d3n8a8pro7vhmx	d3n8a8pro7vhmx.cloudfront.net	-1
frac	frac.org	-1
dailystormer	dailystormer.com	-1
ycombinator	news.ycombinator.com	-1
nsc	nsc.org	-1
wehuntedthemammoth	wehuntedthemammoth.com	-1
imperial	imperial.ac.uk	-1
reports	reports.oah.state.nc.us	-1
pca	pca.st	-1
foxsports	msn.foxsports.com	-1
edmunds	edmunds.com	-1
aifs	aifs.gov.au	-1
piie	piie.com	-1
atheism	atheism.about.com	-1
uptodate	uptodate.com	-1
bet	bet.com	-1
247wallst	247wallst.com	-1
landonswan	blog.landonswan.com	-1
zesty	zesty.ca	-1
rogerebert	rogerebert.com	-1
arc-anglerfish-washpost-prod-washpost	arc-anglerfish-washpost-prod-washpost.s3.amazonaws.com	-1
additudemag	additudemag.com	-1
fraserinstitute	fraserinstitute.org	-1
fifa	fifa.com	-1
curbed	curbed.com	-1
teamliquid	wiki.teamliquid.net	-1
inverse	inverse.com	-1
NationalPopularVote	NationalPopularVote.com	-1
redditinc	redditinc.com	-1
encrypted	encrypted.google.com	-1
skyscraperpage	skyscraperpage.com	-1
food	food.com	-1
geek	geek.com	-1
net	eh.net	-1
pokemondb	pokemondb.net	-1
jbhe	jbhe.com	-1
redlettermedia	redlettermedia.com	-1
cheatsheet	cheatsheet.com	-1
vignette1	vignette1.wikia.nocookie.net	-1
sprc	sprc.org	-1
openculture	openculture.com	-1
peterleeson	peterleeson.com	-1
realclimate	realclimate.org	-1
canlii	canlii.org	-1
givedirectly	givedirectly.org	-1
digitaljournal	digitaljournal.com	-1
advisory	advisory.com	-1
olympic	olympic.org	-1
damninteresting	damninteresting.com	-1
colorlines	colorlines.com	-1
smallarmssurvey	smallarmssurvey.org	-1
cgdev	cgdev.org	-1
ethnicity-facts-figures	ethnicity-facts-figures.service.gov.uk	-1
lawandcrime	lawandcrime.com	-1
thecolbertreport	thecolbertreport.cc.com	-1
tripadvisor	media-cdn.tripadvisor.com	-1
archlinux	bbs.archlinux.org	-1
nasdaq	nasdaq.com	-1
doctorsopposingcircumcision	doctorsopposingcircumcision.org	-1
petmd	petmd.com	-1
oxfordmartin	oxfordmartin.ox.ac.uk	-1
adage	adage.com	-1
genderanalysis	genderanalysis.net	-1
csis	csis.org	-1
corporate	corporate.target.com	-1
presidential-candidates	presidential-candidates.insidegov.com	-1
sltrib	sltrib.com	-1
endhomelessness	endhomelessness.org	-1
drugs	drugs.com	-1
tomwoods	tomwoods.com	-1
nytlive	nytlive.nytimes.com	-1
yelp	yelp.com	-1
shopify	cdn.shopify.com	-1
jordanbpeterson	jordanbpeterson.com	-1
ilga	ilga.org	-1
organicconsumers	organicconsumers.org	-1
seattlepi	blog.seattlepi.com	-1
edge	edge.org	-1
thebureauinvestigates	thebureauinvestigates.com	-1
authoritynutrition	authoritynutrition.com	-1
rooseveltinstitute	rooseveltinstitute.org	-1
amsa	amsa.org	-1
al-islam	al-islam.org	-1
electoralcommission	electoralcommission.org.uk	-1
finallyfeminism101	finallyfeminism101.wordpress.com	-1
middleeasteye	middleeasteye.net	-1
legis	legis.state.pa.us	-1
pcpsr	pcpsr.org	-1
linkinghub	linkinghub.elsevier.com	-1
dana	dana.org	-1
atheists	atheists.org	-1
francoistremblay	francoistremblay.wordpress.com	-1
typepad	a4.typepad.com	-1
mitadmissions	mitadmissions.org	-1
historynet	historynet.com	-1
projectvote	projectvote.org	-1
unwomen	unwomen.org	-1
yaleclimateconnections	yaleclimateconnections.org	-1
maa	maa.org	-1
patch	patch.com	-1
ndaa	ndaa.org	-1
insurancejournal	insurancejournal.com	-1
monster	monster.com	-1
sportsbusinessdaily	sportsbusinessdaily.com	-1
post-gazette	post-gazette.com	-1
syracuse	syracuse.com	-1
myfitnesspal	blog.myfitnesspal.com	-1
turbotax	turbotax.intuit.com	-1
suicidepreventionlifeline	suicidepreventionlifeline.org	-1
historians	historians.org	-1
sandiegouniontribune	sandiegouniontribune.com	-1
jta	jta.org	-1
heart	heart.org	-1
thenextweb	thenextweb.com	-1
womenshealthmag	womenshealthmag.com	-1
mtv	mtv.com	-1
slideshare	slideshare.net	-1
jahonline	jahonline.org	-1
guncite	guncite.com	-1
nielsen	nielsen.com	-1
ncse	ncse.com	-1
lostallhope	lostallhope.com	-1
redditsearch	redditsearch.io	-1
karger	karger.com	-1
wri	wri.org	-1
parentingscience	parentingscience.com	-1
proquest	search.proquest.com	-1
heterodoxacademy	heterodoxacademy.org	-1
nwlc	nwlc.org	-1
vignette2	vignette2.wikia.nocookie.net	-1
infidels	infidels.org	-1
economicsdetective	economicsdetective.com	-1
bitcoin	en.bitcoin.it	-1
thegatewaypundit	thegatewaypundit.com	-1
geekfeminism	geekfeminism.wikia.com	-1
slashdot	slashdot.org	-1
gesetze-im-internet	gesetze-im-internet.de	-1
haydenplanetarium	haydenplanetarium.org	-1
felonvoting	felonvoting.procon.org	-1
consc	consc.net	-1
emedicine	emedicine.medscape.com	-1
wfp	wfp.org	-1
focusonthefamily	dailycitizen.focusonthefamily.com	-1
areavibes	areavibes.com	-1
tesla	tesla.com	-1
christianitytoday	christianitytoday.com	-1
villagevoice	blogs.villagevoice.com	-1
nzherald	nzherald.co.nz	-1
rapgenius	rapgenius.com	-1
storify	storify.com	-1
cochrane	cochrane.org	-1
googleapis	think.storage.googleapis.com	-1
straitstimes	straitstimes.com	-1
elementascience	elementascience.org	-1
oxfordreference	oxfordreference.com	-1
wjla	wjla.com	-1
buzzfed	ak-hdl.buzzfed.com	-1
themoscowtimes	themoscowtimes.com	-1
saveservices	saveservices.org	-1
theundefeated	theundefeated.com	-1
econjwatch	econjwatch.org	-1
hindustantimes	hindustantimes.com	-1
greentechmedia	greentechmedia.com	-1
click	dont.click.hover.for.note	-1
eji	eji.org	-1
sanfrancisco	sanfrancisco.cbslocal.com	-1
familyfacts	familyfacts.org	-1
takepart	takepart.com	-1
crf-usa	crf-usa.org	-1
lifehack	lifehack.org	-1
datagraver	datagraver.com	-1
equitablemath	equitablemath.org	-1
ammoland	ammoland.com	-1
legacy	legacy.tyt.com	-1
thelawdictionary	thelawdictionary.org	-1
shouselaw	shouselaw.com	-1
yourdictionary	yourdictionary.com	-1
uofmhealth	labblog.uofmhealth.org	-1
livemint	livemint.com	-1
biblia	biblia.com	-1
collective-evolution	collective-evolution.com	-1
drinkingage	drinkingage.procon.org	-1
ratical	ratical.org	-1
artofmanliness	artofmanliness.com	-1
pcmag	pcmag.com	-1
freethoughtpedia	freethoughtpedia.com	-1
dailycal	dailycal.org	-1
climatechange2013	climatechange2013.org	-1
dailytelegraph	dailytelegraph.com.au	-1
teachingamericanhistory	teachingamericanhistory.org	-1
alicdn	g03.a.alicdn.com	-1
publicbroadcasting	mediad.publicbroadcasting.net	-1
removeddit	removeddit.com	-1
al-monitor	al-monitor.com	-1
quickmeme	quickmeme.com	-1
kansascity	kansascity.com	-1
ucsfhealth	ucsfhealth.org	-1
ggpht	lh5.ggpht.com	-1
todayifoundout	todayifoundout.com	-1
poynter	poynter.org	-1
zendesk	reddit.zendesk.com	-1
skepdic	skepdic.com	-1
audible	audible.com	-1
biorxiv	biorxiv.org	-1
nccp	nccp.org	-1
nea	nea.org	-1
abovethelaw	abovethelaw.com	-1
upc-online	upc-online.org	-1
abc13	abc13.com	-1
aol	aol.com	-1
timeout	media.timeout.com	-1
diversityinc	diversityinc.com	-1
practicalethics	blog.practicalethics.ox.ac.uk	-1
wgntv	wgntv.com	-1
suicide	suicide.org	-1
iranprimer	iranprimer.usip.org	-1
raceandpolicing	raceandpolicing.issuelab.org	-1
thesimpledollar	thesimpledollar.com	-1
collegereadiness	collegereadiness.collegeboard.org	-1
zpub	zpub.com	-1
usdebtclock	usdebtclock.org	-1
justicepolicy	justicepolicy.org	-1
naturalfinance	naturalfinance.net	-1
recode	recode.net	-1
celebritynetworth	celebritynetworth.com	-1
prostitutionresearch	prostitutionresearch.com	-1
nbcwashington	nbcwashington.com	-1
instituteforenergyresearch	instituteforenergyresearch.org	-1
stateofobesity	stateofobesity.org	-1
abc7chicago	abc7chicago.com	-1
newamerica	static.newamerica.org	-1
tolerance	tolerance.org	-1
thelastpsychiatrist	thelastpsychiatrist.com	-1
reducing-suffering	reducing-suffering.org	-1
mondoweiss	mondoweiss.net	-1
thedodo	thedodo.com	-1
thedailybanter	thedailybanter.com	-1
desmoinesregister	desmoinesregister.com	-1
list	list.ly	-1
centerforsecuritypolicy	centerforsecuritypolicy.org	-1
jihadwatch	jihadwatch.org	-1
elderscrolls	elderscrolls.wikia.com	-1
emerald	emerald.com	-1
euractiv	euractiv.com	-1
chomsky	chomsky.info	-1
info	web.mta.info	-1
powerlisting	powerlisting.wikia.com	-1
kidney	kidney.org	-1
pollingreport	pollingreport.com	-1
perl6	docs.perl6.org	-1
kidshealth	kidshealth.org	-1
peoplespolicyproject	peoplespolicyproject.org	-1
harvardpolitics	harvardpolitics.com	-1
poets	poets.org	-1
macmillandictionary	macmillandictionary.com	-1
guim	i.guim.co.uk	-1
dailystar	dailystar.com.lb	-1
nbclosangeles	nbclosangeles.com	-1
techrepublic	techrepublic.com	-1
osf	osf.com	-1
self-compassion	self-compassion.org	-1
markmanson	markmanson.net	-1
911myths	911myths.com	-1
stateofworkingamerica	stateofworkingamerica.org	-1
muhealth	muhealth.org	-1
moviezhubb	moviezhubb.org	-1
randomcriticalanalysis	randomcriticalanalysis.com	-1
techtimes	techtimes.com	-1
legalinsurrection	legalinsurrection.com	-1
reference	reference.com	-1
lse	lse.ac.uk	-1
oldearth	oldearth.org	-1
evolution-institute	evolution-institute.org	-1
autostraddle	autostraddle.com	-1
aacrjournals	cebp.aacrjournals.org	-1
modernfarmer	modernfarmer.com	-1
seeker	seeker.com	-1
jonathanturley	jonathanturley.org	-1
btselem	btselem.org	-1
crowdstrike	crowdstrike.com	-1
danceswithfat	danceswithfat.wordpress.com	-1
nationalacademies	www8.nationalacademies.org	-1
philosophybasics	philosophybasics.com	-1
middleeastmonitor	middleeastmonitor.com	-1
twincities	twincities.com	-1
inthesetimes	inthesetimes.com	-1
shutterstock	image.shutterstock.com	-1
citizensclimatelobby	citizensclimatelobby.org	-1
babe	babe.net	-1
care2	care2.com	-1
americananthro	perspectives.americananthro.org	-1
media1	media1.tenor.com	-1
firstamendmentcenter	firstamendmentcenter.org	-1
yalelawjournal	yalelawjournal.org	-1
thetrevorproject	thetrevorproject.org	-1
goodhousekeeping	goodhousekeeping.com	-1
mathworld	mathworld.wolfram.com	-1
truthdig	truthdig.com	-1
23andme	blog.23andme.com	-1
ozy	ozy.com	-1
digest	digest.bps.org.uk	-1
iwf	iwf.org	-1
firstthings	firstthings.com	-1
nbcchicago	nbcchicago.com	-1
nelp	nelp.org	-1
int	int.nyt.com	-1
scottaaronson	scottaaronson.com	-1
eur-lex	eur-lex.europa.eu	-1
stratfor	stratfor.com	-1
biologicaldiversity	biologicaldiversity.org	-1
masstagger	masstagger.com	-1
esa	esa.un.org	-1
marieclaire	marieclaire.com	-1
intechopen	intechopen.com	-1
giffords	giffords.org	-1
ehow	ehow.com	-1
mensa	mensa.ch	-1
scottishtrans	scottishtrans.org	-1
scienceline	scienceline.org	-1
kottke	kottke.org	-1
thehotline	thehotline.org	-1
jech	jech.bmj.com	-1
scielo	scielo.br	-1
rewire	rewire.news	-1
thepublicdiscourse	thepublicdiscourse.com	-1
prochoiceactionnetwork-canada	prochoiceactionnetwork-canada.org	-1
harpersbazaar	harpersbazaar.com	-1
bipartisanpolicy	bipartisanpolicy.org	-1
doctornerdlove	doctornerdlove.com	-1
prntscr	prntscr.com	-1
outsidethebeltway	outsidethebeltway.com	-1
plannedparenthoodaction	plannedparenthoodaction.org	-1
armedwithreason	armedwithreason.com	-1
out	out.com	-1
giantbomb	static.giantbomb.com	-1
fasebj	fasebj.org	-1
tesco	tesco.com	-1
phillymag	phillymag.com	-1
iraqbodycount	iraqbodycount.org	-1
jacksonville	jacksonville.com	-1
lib	ir.lib.uwo.ca	-1
webcitation	webcitation.org	-1
aclusocal	aclusocal.org	-1
firstpost	firstpost.com	-1
investor	investor.aetna.com	-1
vgy	vgy.me	-1
pure	pure.uvt.nl	-1
ajpmonline	ajpmonline.org	-1
stanleycolors	stanleycolors.com	-1
inhabitat	assets.inhabitat.com	-1
cbr	cbr.com	-1
theodysseyonline	theodysseyonline.com	-1
joineps	joineps.ca	-1
endofwomen	endofwomen.blogspot.com	-1
niskanencenter	niskanencenter.org	-1
security	security.blogs.cnn.com	-1
worlddata	worlddata.info	-1
thefreelibrary	thefreelibrary.com	-1
appleinsider	appleinsider.com	-1
project-syndicate	project-syndicate.org	-1
c2es	c2es.org	-1
pennmedicine	pennmedicine.org	-1
weedcontrolfreaks	weedcontrolfreaks.com	-1
biofortified	biofortified.org	-1
target	target.com	-1
globalsecurity	globalsecurity.org	-1
warwick	blogs.warwick.ac.uk	-1
transpulseproject	transpulseproject.ca	-1
prepscholar	blog.prepscholar.com	-1
ichef-1	ichef-1.bbci.co.uk	-1
mcdonalds	mcdonalds.com	-1
seekingalpha	seekingalpha.com	-1
ncronline	ncronline.org	-1
grandin	grandin.com	-1
nebraskamed	nebraskamed.com	-1
mrmoneymustache	mrmoneymustache.com	-1
acs	acs.org	-1
aaas	aaas.org	-1
drivinglaws	drivinglaws.org	-1
nonbinary	nonbinary.org	-1
tinyurl	tinyurl.com	-1
thrillist	thrillist.com	-1
pornhub	help.pornhub.com	-1
norml	blog.norml.org	-1
precaution	precaution.org	-1
vrg	vrg.org	-1
ehbonline	ehbonline.org	-1
cmsny	cmsny.org	-1
federalsafetynet	federalsafetynet.com	-1
cleanenergywire	cleanenergywire.org	-1
ecowatch	ecowatch.com	-1
orwell	orwell.ru	-1
bleedingheartlibertarians	bleedingheartlibertarians.com	-1
asexuality	asexuality.org	-1
threadreaderapp	threadreaderapp.com	-1
police	police.gov.hk	-1
cincinnati	cincinnati.com	-1
magiccards	magiccards.info	-1
jordanthebrobot	jordanthebrobot.com	-1
bfro	bfro.net	-1
jneurosci	jneurosci.org	-1
nuclearsecrecy	nuclearsecrecy.com	-1
learncpp	learncpp.com	-1
southpark	southpark.cc.com	-1
redditcommentsearch	redditcommentsearch.com	-1
stat	stat.fi	-1
unfpa	unfpa.org	-1
gsmarena	cdn2.gsmarena.com	-1
freenation	freenation.org	-1
kztoolbox	kztoolbox.com	-1
facdn	d.facdn.net	-1
necrometrics	necrometrics.com	-1
whitehousehistory	whitehousehistory.org	-1
internationalinsurance	internationalinsurance.com	-1
nleomf	nleomf.org	-1
yalemedicine	yalemedicine.org	-1
rapecrisis	rapecrisis.org.uk	-1
differencebetween	differencebetween.com	-1
theculturetrip	theculturetrip.com	-1
scidev	scidev.net	-1
goarmy	goarmy.com	-1
memegenerator	memegenerator.net	-1
economistsview	economistsview.typepad.com	-1
frc	frc.org	-1
civil-war	civil-war.net	-1
dailywritingtips	dailywritingtips.com	-1
archives-ouvertes	hal.archives-ouvertes.fr	-1
shorensteincenter	shorensteincenter.org	-1
digital	fsu.digital.flvc.org	-1
ascd	ascd.org	-1
rte	rte.ie	-1
fox2now	fox2now.com	-1
goodtherapy	goodtherapy.org	-1
needhelppayingbills	needhelppayingbills.com	-1
veganhealth	veganhealth.org	-1
threefeloniesaday	threefeloniesaday.com	-1
dogbreedinfo	dogbreedinfo.com	-1
dailyanarchist	dailyanarchist.com	-1
bloximages	bloximages.chicago2.vip.townnews.com	-1
charlotteobserver	charlotteobserver.com	-1
bastiat	bastiat.org	-1
inquirer	inquirer.com	-1
ewg	ewg.org	-1
intersexequality	intersexequality.com	-1
nheri	nheri.org	-1
lawyers	lawyers.com	-1
radd	radd.it	-1
changemyview	changemyview.net	-1
worldfuturefund	worldfuturefund.org	-1
harvardlawreview	harvardlawreview.org	-1
nongmoproject	nongmoproject.org	-1
quickanddirtytips	quickanddirtytips.com	-1
rfa	rfa.org	-1
theadvocates	theadvocates.org	-1
halls	halls.md	-1
bestbuy	bestbuy.ca	-1
sefaria	sefaria.org	-1
twitchy	twitchy.com	-1
wsws	wsws.org	-1
doingbusiness	doingbusiness.org	-1
wusa9	wusa9.com	-1
nationalaffairs	nationalaffairs.com	-1
publicreligion	publicreligion.org	-1
nationaleatingdisorders	nationaleatingdisorders.org	-1
globalpost	globalpost.com	-1
americanadoptions	americanadoptions.com	-1
external-preview	external-preview.redd.it	-1
www-tc	www-tc.pbs.org	-1
eonline	eonline.com	-1
bitesizevegan	bitesizevegan.com	-1
plosmedicine	plosmedicine.org	-1
econofact	econofact.org	-1
secularprolife	secularprolife.org	-1
healthday	consumer.healthday.com	-1
twitch	twitch.tv	-1
clasp	clasp.org	-1
atts	atts.org	-1
sportsci	sportsci.org	-1
espnfivethirtyeight	espnfivethirtyeight.files.wordpress.com	-1
gofundme	gofundme.com	-1
truthout	truthout.org	-1
elle	elle.com	-1
ning	api.ning.com	-1
learner	learner.org	-1
immigrationforum	immigrationforum.org	-1
thisisinsider	thisisinsider.com	-1
victimsofcrime	victimsofcrime.org	-1
priceofoil	priceofoil.org	-1
biomedsearch	biomedsearch.com	-1
powerlineblog	powerlineblog.com	-1
waterfootprint	waterfootprint.org	-1
torontoist	torontoist.com	-1
lrb	lrb.co.uk	-1
shootingtracker	shootingtracker.com	-1
moma	moma.org	-1
wto	wto.org	-1
stevenpinker	stevenpinker.com	-1
forums	forums.randi.org	-1
newnownext	newnownext.com	-1
bmjopen	bmjopen.bmj.com	-1
strongtowns	strongtowns.org	-1
iii	iii.org	-1
skepticalinquirer	skepticalinquirer.org	-1
gamerant	gamerant.com	-1
thebalancecareers	thebalancecareers.com	-1
curiosity	curiosity.discovery.com	-1
downsizinggovernment	downsizinggovernment.org	-1
runnersworld	runnersworld.com	-1
treatmentadvocacycenter	treatmentadvocacycenter.org	-1
followtheintuition	followtheintuition.com	-1
reviewjournal	reviewjournal.com	-1
historyisaweapon	historyisaweapon.com	-1
mkorostoff	mkorostoff.github.io	-1
healthdata	healthdata.org	-1
cep	cep.lse.ac.uk	-1
aei-ideas	aei-ideas.org	-1
animalcharityevaluators	animalcharityevaluators.org	-1
home	home.nra.org	-1
evonomics	evonomics.com	-1
europarl	europarl.europa.eu	-1
marinecorpstimes	marinecorpstimes.com	-1
debunking911	debunking911.com	-1
utilitarianism	utilitarianism.net	-1
ancient-origins	ancient-origins.net	-1
word	i.word.com	-1
acleddata	acleddata.com	-1
thelifeyoucansave	thelifeyoucansave.org.au	-1
aclum	aclum.org	-1
prageru	prageru.com	-1
clarionproject	clarionproject.org	-1
edf	edf.org	-1
takingnote	takingnote.blogs.nytimes.com	-1
voices	voices.yahoo.com	-1
odmp	odmp.org	-1
tonic	tonic.vice.com	-1
adamsmith	adamsmith.org	-1
laweekly	laweekly.com	-1
singularityhub	singularityhub.com	-1
muslimstatistics	muslimstatistics.files.wordpress.com	-1
diabetes	diabetes.org	-1
voteview	voteview.com	-1
static-economist	cdn.static-economist.com	-1
amzn	amzn.to	-1
akns-images	akns-images.eonline.com	-1
nbcphiladelphia	nbcphiladelphia.com	-1
culturalsurvival	culturalsurvival.org	-1
humanrightsfirst	humanrightsfirst.org	-1
fatherly	fatherly.com	-1
clevelandfed	clevelandfed.org	-1
globaltimes	globaltimes.cn	-1
aacap	aacap.org	-1
weknowmemes	weknowmemes.com	-1
whatever	whatever.scalzi.com	-1
androidauthority	androidauthority.com	-1
mentalhelp	mentalhelp.net	-1
publicseminar	publicseminar.org	-1
aidsmap	aidsmap.com	-1
thedrive	thedrive.com	-1
ips-dc	ips-dc.org	-1
casetext	casetext.com	-1
thegrio	thegrio.com	-1
quranx	quranx.com	-1
patents	patents.google.com	-1
nfpa	nfpa.org	-1
drgo	drgo.us	-1
mixtape	track3.mixtape.moe	-1
blackpast	blackpast.org	-1
abcbirds	abcbirds.org	-1
bankofengland	bankofengland.co.uk	-1
economonitor	economonitor.com	-1
eastbayexpress	m.eastbayexpress.com	-1
myflorida	dos.myflorida.com	-1
thegreatcourses	thegreatcourses.com	-1
wtvr	wtvr.com	-1
slashfilm	slashfilm.com	-1
graphics	graphics.wsj.com	-1
shanghairanking	shanghairanking.com	-1
wolf-pac	wolf-pac.com	-1
avp	avp.org	-1
crmvet	crmvet.org	-1
ktla	ktla.com	-1
bostonherald	bostonherald.com	-1
leagueoflegends	na.leagueoflegends.com	-1
bloomberglaw	news.bloomberglaw.com	-1
genderratic	genderratic.com	-1
climateactiontracker	climateactiontracker.org	-1
ibo	ibo.org	-1
hc-sc	hc-sc.gc.ca	-1
howtogeek	howtogeek.com	-1
adn	adn.com	-1
evilbible	evilbible.com	-1
gamerevolution	gamerevolution.com	-1
washingtonblade	washingtonblade.com	-1
objectivismforintellectuals	objectivismforintellectuals.wordpress.com	-1
acm	acm.org	-1
parahumans	parahumans.wordpress.com	-1
dumblaws	dumblaws.com	-1
atomicheritage	atomicheritage.org	-1
informahealthcare	informahealthcare.com	-1
yesmagazine	yesmagazine.org	-1
climatecentral	climatecentral.org	-1
projectcensored	projectcensored.org	-1
ajmc	ajmc.com	-1
madd	madd.org	-1
crooksandliars	crooksandliars.com	-1
ocregister	ocregister.com	-1
me	me.me	-1
whyevolutionistrue	whyevolutionistrue.wordpress.com	-1
substack	taibbi.substack.com	-1
govdelivery	content.govdelivery.com	-1
discover	discover.hubpages.com	-1
ifpri	ifpri.org	-1
sexchangeregret	sexchangeregret.com	-1
theflatearthsociety	theflatearthsociety.org	-1
govexec	govexec.com	-1
taskandpurpose	taskandpurpose.com	-1
wixstatic	docs.wixstatic.com	-1
ritholtz	ritholtz.com	-1
electronicintifada	electronicintifada.net	-1
humanrights	humanrights.gov.au	-1
pitchfork	pitchfork.com	-1
metmuseum	metmuseum.org	-1
verdict	verdict.co.uk	-1
comicbook	comicbook.com	-1
gertstulp	gertstulp.com	-1
petapixel	petapixel.com	-1
everycrsreport	everycrsreport.com	-1
bostonfed	bostonfed.org	-1
routledge	cw.routledge.com	-1
transascity	transascity.org	-1
scholastic	mediaroom.scholastic.com	-1
wada-ama	wada-ama.org	-1
gizmag	gizmag.com	-1
datagoneodd	datagoneodd.com	-1
heartiste	heartiste.wordpress.com	-1
resources	resources.saylor.org	-1
chess	chess.com	-1
usconstitution	usconstitution.net	-1
sillyolme	sillyolme.wordpress.com	-1
ncdsv	ncdsv.org	-1
newjimcrow	newjimcrow.com	-1
thespruce	thespruce.com	-1
citypages	blogs.citypages.com	-1
letmegooglethat	letmegooglethat.com	-1
medicalmarijuana	medicalmarijuana.procon.org	-1
transcripts	transcripts.cnn.com	-1
opb	opb.org	-1
ypdcrime	ypdcrime.com	-1
netmarketshare	netmarketshare.com	-1
tribune	tribune.com.pk	-1
thecriminallawyer	thecriminallawyer.tumblr.com	-1
911review	911review.com	-1
geekwire	geekwire.com	-1
transcience-project	transcience-project.org	-1
opentextbc	opentextbc.ca	-1
thestreet	thestreet.com	-1
assaultweapon	assaultweapon.info	-1
vote	vote.org	-1
maggiemcneill	maggiemcneill.wordpress.com	-1
ebscohost	eds.a.ebscohost.com	-1
timeanddate	timeanddate.com	-1
defenseone	defenseone.com	-1
blueletterbible	blueletterbible.org	-1
indiancountrytodaymedianetwork	indiancountrytodaymedianetwork.com	-1
government	government.nl	-1
dispatch	dispatch.com	-1
silverchair	watermark.silverchair.com	-1
sizediversityandhealth	sizediversityandhealth.org	-1
zeit	zeit.de	-1
monthlyreview	monthlyreview.org	-1
universetoday	universetoday.com	-1
yourtango	yourtango.com	-1
usgovinfo	usgovinfo.about.com	-1
pressreader	pressreader.com	-1
maths	plus.maths.org	-1
tennessean	tennessean.com	-1
metafilter	ask.metafilter.com	-1
pressherald	pressherald.com	-1
dealbook	dealbook.nytimes.com	-1
shadowproof	shadowproof.com	-1
euro	euro.who.int	-1
nceo	nceo.org	-1
nei	nei.org	-1
pictures	www2.pictures.zimbio.com	-1
responsiblelending	responsiblelending.org	-1
utsandiego	utsandiego.com	-1
etsg	etsg.org	-1
theknot	theknot.com	-1
blackdemographics	blackdemographics.com	-1
npiamerica	npiamerica.org	-1
chinadaily	chinadaily.com.cn	-1
battlefields	battlefields.org	-1
therecoveryvillage	therecoveryvillage.com	-1
rcmp-grc	rcmp-grc.gc.ca	-1
navytimes	navytimes.com	-1
sott	sott.net	-1
meme	cdn.meme.am	-1
uproxx	uproxx.com	-1
reproductiverights	reproductiverights.org	-1
judicialwatch	judicialwatch.org	-1
global	global.oup.com	-1
laurieximenez	laurieximenez.files.wordpress.com	-1
healthyeating	healthyeating.sfgate.com	-1
gunowners	gunowners.org	-1
judiciary	judiciary.gov.uk	-1
omicsonline	omicsonline.org	-1
nhl	nhl.com	-1
forbesimg	b-i.forbesimg.com	-1
pottermore	pottermore.com	-1
feministe	feministe.us	-1
brainblogger	brainblogger.com	-1
asanet	asanet.org	-1
thepoliticalinsider	thepoliticalinsider.com	-1
wisegeek	wisegeek.net	-1
telesurenglish	telesurenglish.net	-1
jamestown	jamestown.org	-1
preprints	preprints.org	-1
tardis	tardis.wikia.com	-1
neurology	neurology.org	-1
admin	eda.admin.ch	-1
uschamber	uschamber.com	-1
copyhype	copyhype.com	-1
poseidon01	poseidon01.ssrn.com	-1
everydaynodaysoff	everydaynodaysoff.com	-1
rcog	rcog.org.uk	-1
skepticalraptor	skepticalraptor.com	-1
themarysue	themarysue.com	-1
ingramdaily	ingramdaily.com	-1
uselectionatlas	uselectionatlas.org	-1
newobserveronline	newobserveronline.com	-1
index	index.rsf.org	-1
thebulletin	thebulletin.org	-1
libertyfund	oll.libertyfund.org	-1
tvbythenumbers	tvbythenumbers.zap2it.com	-1
etsystatic	i.etsystatic.com	-1
factmyth	factmyth.com	-1
drawdown	drawdown.org	-1
avmajournals	avmajournals.avma.org	-1
stanrock	stanrock.net	-1
bostonmagazine	bostonmagazine.com	-1
financialpost	business.financialpost.com	-1
yourbrainonporn	yourbrainonporn.com	-1
uni-muenchen	mpra.ub.uni-muenchen.de	-1
witchwind	witchwind.wordpress.com	-1
famousscientists	famousscientists.org	-1
whattoexpect	whattoexpect.com	-1
thenib	thenib.com	-1
villainouscompany	villainouscompany.com	-1
quantamagazine	quantamagazine.org	-1
bodybuilding	bodybuilding.com	-1
iqcomparisonsite	iqcomparisonsite.com	-1
video	video.pbs.org	-1
talkpoverty	talkpoverty.org	-1
joelonsoftware	joelonsoftware.com	-1
playstation	playstation.com	-1
texasobserver	texasobserver.org	-1
notabug	snew.notabug.io	-1
bizpacreview	bizpacreview.com	-1
feminspire	feminspire.com	-1
boysvswomen	boysvswomen.com	-1
courant	courant.com	-1
verywell	verywell.com	-1
ncadd	ncadd.org	-1
goodcall	goodcall.com	-1
bfy	bfy.tw	-1
aflcio	aflcio.org	-1
iheart	iheart.com	-1
fastcodesign	fastcodesign.com	-1
itv	itv.com	-1
resavr	resavr.com	-1
mercyforanimals	mercyforanimals.org	-1
knoema	knoema.com	-1
explainxkcd	explainxkcd.com	-1
healthinsurance	healthinsurance.org	-1
disabilityscoop	disabilityscoop.com	-1
resilience	resilience.org	-1
sodahead	images.sodahead.com	-1
electionscience	electionscience.github.io	-1
attn	attn.com	-1
topdocumentaryfilms	topdocumentaryfilms.com	-1
edwardfeser	edwardfeser.blogspot.fr	-1
brightspotcdn	ca-times.brightspotcdn.com	-1
telesurtv	telesurtv.net	-1
hslda	hslda.org	-1
adfontesmedia	adfontesmedia.com	-1
thefederalistpapers	thefederalistpapers.org	-1
kiro7	kiro7.com	-1
ksl	ksl.com	-1
brilliant	brilliant.org	-1
injuryfacts	injuryfacts.nsc.org	-1
project	project.wnyc.org	-1
wikiart	wikiart.org	-1
ncfm	ncfm.org	-1
sunlightfoundation	sunlightfoundation.com	-1
ox	ox.ac.uk	-1
veganoutreach	veganoutreach.org	-1
softpedia	news.softpedia.com	-1
centerforpolitics	centerforpolitics.org	-1
cookpolitical	cookpolitical.com	-1
visionofhumanity	visionofhumanity.org	-1
haescommunity	haescommunity.com	-1
hoplofobia	hoplofobia.info	-1
humankinetics	humankinetics.com	-1
save	save.org	-1
madamenoire	madamenoire.com	-1
securitydata	securitydata.newamerica.net	-1
emeraldinsight	emeraldinsight.com	-1
nintendo	nintendo.com	-1
rcfp	rcfp.org	-1
u-s-history	u-s-history.com	-1
chicagomag	chicagomag.com	-1
economicsonline	economicsonline.co.uk	-1
homedepot	homedepot.com	-1
aha	aha.org	-1
checkyourfact	checkyourfact.com	-1
usgovernmentrevenue	usgovernmentrevenue.com	-1
kentucky	kentucky.com	-1
cgpublisher	jrci.cgpublisher.com	-1
pennlive	pennlive.com	-1
biologists	bio.biologists.org	-1
sbtl	sbtl.tv	-1
globalpolicy	globalpolicy.org	-1
ymcdn	c.ymcdn.com	-1
uesp	uesp.net	-1
americablog	americablog.com	-1
thepatientfactor	thepatientfactor.com	-1
contexts	contexts.org	-1
kateharding	kateharding.net	-1
adaa	adaa.org	-1
mg	mg.co.za	-1
zmescience	zmescience.com	-1
mhanational	mhanational.org	-1
csicop	csicop.org	-1
billofrightsinstitute	billofrightsinstitute.org	-1
hennepin	hennepin.us	-1
macrumors	macrumors.com	-1
battle	us.battle.net	-1
nysscpa	nysscpa.org	-1
ancestry	ancestry.com	-1
edition-m	edition-m.cnn.com	-1
edgarsnyder	edgarsnyder.com	-1
circumstitions	circumstitions.com	-1
vawnet	vawnet.org	-1
gaylife	gaylife.about.com	-1
freepress	freepress.net	-1
echr	echr.coe.int	-1
uspirg	uspirg.org	-1
america	america.pink	-1
virped	virped.org	-1
owl232	owl232.net	-1
populationpyramid	populationpyramid.net	-1
studentloanhero	studentloanhero.com	-1
isreview	isreview.org	-1
enveurope	enveurope.com	-1
wiki	wiki.tfes.org	-1
profootballtalk	profootballtalk.nbcsports.com	-1
star-telegram	star-telegram.com	-1
unep	unep.org	-1
gun-nuttery	gun-nuttery.com	-1
thumbs	thumbs.gfycat.com	-1
aps	aps.org	-1
fallacyfiles	fallacyfiles.org	-1
davidsongifted	davidsongifted.org	-1
geekparty	geekparty.com	-1
ciwf	ciwf.org.uk	-1
queerty	queerty.com	-1
afr	afr.com	-1
strikemag	strikemag.org	-1
soylent	soylent.com	-1
chalkbeat	chalkbeat.org	-1
cato-unbound	cato-unbound.org	-1
collegedata	collegedata.com	-1
antiwar	antiwar.com	-1
gender	gender.wikia.org	-1
ifs	ifs.org.uk	-1
inis	inis.iaea.org	-1
queensu	queensu.ca	-1
rateyourmusic	rateyourmusic.com	-1
autotrader	autotrader.com	-1
friendlyatheist	friendlyatheist.patheos.com	-1
meetup	meetup.com	-1
oregonlaws	oregonlaws.org	-1
econpapers	econpapers.repec.org	-1
realclearmarkets	realclearmarkets.com	-1
texasmonthly	texasmonthly.com	-1
gamefaqs	gamefaqs.gamespot.com	-1
racialequitytools	racialequitytools.org	-1
abolition	abolition.e2bn.org	-1
ancient	ancient.eu	-1
workplacefairness	workplacefairness.org	-1
discordapp	cdn.discordapp.com	-1
worldlifeexpectancy	worldlifeexpectancy.com	-1
bbcgoodfood	bbcgoodfood.com	-1
usmilitary	usmilitary.about.com	-1
6abc	6abc.com	-1
tate	tate.org.uk	-1
scimagojr	scimagojr.com	-1
naturalsociety	naturalsociety.com	-1
stormfront	stormfront.org	-1
strategicstudiesinstitute	strategicstudiesinstitute.army.mil	-1
gocomics	gocomics.com	-1
marshallbrain	marshallbrain.com	-1
chicagofed	chicagofed.org	-1
merckmanuals	merckmanuals.com	-1
spiked-online	spiked-online.com	-1
obesity	obesity.org	-1
profezie3m	profezie3m.altervista.org	-1
kanzenshuu	kanzenshuu.com	-1
kmov	kmov.com	-1
mentalillnesspolicy	mentalillnesspolicy.org	-1
migrationobservatory	migrationobservatory.ox.ac.uk	-1
baltimore	baltimore.cbslocal.com	-1
datausa	datausa.io	-1
ucl	ucl.ac.uk	-1
cosmosmagazine	cosmosmagazine.com	-1
wamu	wamu.org	-1
smithsonianchannel	smithsonianchannel.com	-1
myjewishlearning	myjewishlearning.com	-1
informationclearinghouse	informationclearinghouse.info	-1
guardianlv	guardianlv.com	-1
publicsafety	publicsafety.gc.ca	-1
indianexpress	indianexpress.com	-1
dazeddigital	dazeddigital.com	-1
chriskresser	chriskresser.com	-1
vgsales	vgsales.wikia.com	-1
aattp	aattp.org	-1
brilliantmaps	brilliantmaps.com	-1
shmoop	shmoop.com	-1
rockpapershotgun	rockpapershotgun.com	-1
eje-online	eje-online.org	-1
aaregistry	aaregistry.org	-1
pfizer	pfizer.com	-1
hawking	hawking.org.uk	-1
vignette4	vignette4.wikia.nocookie.net	-1
hudexchange	hudexchange.info	-1
thecrimereport	thecrimereport.org	-1
americanhumane	americanhumane.org	-1
makeuseof	makeuseof.com	-1
wikifur	en.wikifur.com	-1
lawnewz	lawnewz.com	-1
5harad	5harad.com	-1
yalescientific	yalescientific.org	-1
worldvision	worldvision.org	-1
smogon	smogon.com	-1
scpr	scpr.org	-1
icd	icd.who.int	-1
racp	racp.edu.au	-1
mcgilldaily	mcgilldaily.com	-1
empirische-bildungsforschung-bmbf	empirische-bildungsforschung-bmbf.de	-1
thetrumpet	thetrumpet.com	-1
prezi	prezi.com	-1
breakingthescience	breakingthescience.org	-1
navy	c7f.navy.mil	-1
moralfoundations	moralfoundations.org	-1
americansfortaxfairness	americansfortaxfairness.org	-1
thegreenpapers	thegreenpapers.com	-1
funnyjunk	funnyjunk.com	-1
nacwa	nacwa.org	-1
t-nation	t-nation.com	-1
oecd-nea	oecd-nea.org	-1
essence	essence.com	-1
armscontrol	armscontrol.org	-1
shakesville	shakesville.com	-1
stopstreetharassment	stopstreetharassment.org	-1
tomshardware	tomshardware.com	-1
oilprice	oilprice.com	-1
wunderground	wunderground.com	-1
mybudget360	mybudget360.com	-1
overcast	overcast.fm	-1
westernjournalism	westernjournalism.com	-1
bernardokastrup	bernardokastrup.com	-1
tdpf	tdpf.org.uk	-1
deptofnumbers	deptofnumbers.com	-1
theappeal	theappeal.org	-1
overpopulationisamyth	overpopulationisamyth.com	-1
ofcom	ofcom.org.uk	-1
aynrand	estore.aynrand.org	-1
politics	politics.suntimes.com	-1
reactiongifs	reactiongifs.us	-1
operations	operations.nfl.com	-1
neighborhoodscout	neighborhoodscout.com	-1
magaimg	i.magaimg.net	-1
realtor	realtor.com	-1
greencarreports	greencarreports.com	-1
thenational	thenational.ae	-1
shape	shape.com	-1
qr	qr.ae	-1
movember	uk.movember.com	-1
topspeed	topspeed.com	-1
postsecondary	postsecondary.org	-1
king5	king5.com	-1
biospace	biospace.com	-1
vg247	vg247.com	-1
baltimorechronicle	baltimorechronicle.com	-1
h-cdn	sev.h-cdn.co	-1
berkeleyearth	berkeleyearth.org	-1
kaiserfamilyfoundation	kaiserfamilyfoundation.files.wordpress.com	-1
popsugar	popsugar.com	-1
howmuch	howmuch.net	-1
copyrightalliance	copyrightalliance.org	-1
fpif	fpif.org	-1
iapsych	iapsych.com	-1
socialpathology	socialpathology.blogspot.com.au	-1
mensstudies	mensstudies.com	-1
effectivealtruism	effectivealtruism.org	-1
photoshelter	cdn.c.photoshelter.com	-1
scholarsstrategynetwork	scholarsstrategynetwork.org	-1
in2013dollars	in2013dollars.com	-1
forksoverknives	forksoverknives.com	-1
infoproc	infoproc.blogspot.com	-1
rxlist	rxlist.com	-1
louderwithcrowder	louderwithcrowder.com	-1
policemag	policemag.com	-1
bestplaces	bestplaces.net	-1
xinhuanet	xinhuanet.com	-1
steamcommunity	steamcommunity.com	-1
stlpublicradio	news.stlpublicradio.org	-1
freedomtomarry	freedomtomarry.org	-1
stonewall	stonewall.org.uk	-1
collegefactual	collegefactual.com	-1
alzheimers	alzheimers.org.uk	-1
marchofdimes	marchofdimes.org	-1
cam	cam.ac.uk	-1
fimfiction	fimfiction.net	-1
modernhealthcare	modernhealthcare.com	-1
debates	debates.org	-1
worldcat	worldcat.org	-1
yaqeeninstitute	yaqeeninstitute.org	-1
sexualobjectification	sexualobjectification.blogspot.com	-1
metabunk	metabunk.org	-1
populartechnology	populartechnology.net	-1
campusreform	campusreform.org	-1
thecrownestate	thecrownestate.co.uk	-1
gregmankiw	gregmankiw.blogspot.com	-1
equitablegrowth	equitablegrowth.org	-1
davidlisak	davidlisak.com	-1
gamergate	gamergate.me	-1
mormon	mormon.org	-1
qntm	qntm.org	-1
icrc	icrc.org	-1
azquotes	azquotes.com	-1
singlemotherguide	singlemotherguide.com	-1
comicsalliance	comicsalliance.com	-1
warontherocks	warontherocks.com	-1
eventhubs	eventhubs.com	-1
oncampus	oncampus.macleans.ca	-1
suicideinfo	suicideinfo.ca	-1
narrative-collapse	narrative-collapse.com	-1
247sports	247sports.com	-1
princetonspear	princetonspear.com	-1
beyondveg	beyondveg.com	-1
venezuelanalysis	venezuelanalysis.com	-1
insights	insights.dice.com	-1
intel	ark.intel.com	-1
apnorc	apnorc.org	-1
fandom	avp.fandom.com	-1
danariely	danariely.files.wordpress.com	-1
springfieldspringfield	springfieldspringfield.co.uk	-1
toysoldier	toysoldier.wordpress.com	-1
cairn	cairn.info	-1
spj	spj.org	-1
kdvr	kdvr.com	-1
losangeles	losangeles.cbslocal.com	-1
zhimg	pic1.zhimg.com	-1
drugpatentwatch	drugpatentwatch.com	-1
prettylittletattoos	prettylittletattoos.tumblr.com	-1
godaddy	godaddy.com	-1
worldstopexports	worldstopexports.com	-1
thepeoplehistory	thepeoplehistory.com	-1
publicpolicy	publicpolicy.verizon.com	-1
carnegiecouncil	carnegiecouncil.org	-1
thefeministwire	thefeministwire.com	-1
michiganradio	michiganradio.org	-1
gavi	gavi.org	-1
genderbread	genderbread.org	-1
international	international.thenewslens.com	-1
heraldscotland	heraldscotland.com	-1
emcdda	emcdda.europa.eu	-1
saf	saf.org	-1
herculesandtheumpire	herculesandtheumpire.com	-1
patdollard	patdollard.com	-1
ukpublicspending	ukpublicspending.co.uk	-1
visual	blog.visual.ly	-1
historyextra	historyextra.com	-1
mcall	mcall.com	-1
divorce	divorce.com	-1
bom	bom.gov.au	-1
akc	akc.org	-1
jampac	jampac.us	-1
targetmap	targetmap.com	-1
rashiyomi	rashiyomi.com	-1
beyondblue	beyondblue.org.au	-1
barnesandnoble	barnesandnoble.com	-1
houstonchronicle	houstonchronicle.com	-1
yadvashem	yadvashem.org	-1
rightwingwatch	rightwingwatch.org	-1
grantland	grantland.com	-1
gamesindustry	gamesindustry.biz	-1
kutv	kutv.com	-1
vogue	vogue.com	-1
annenbergpublicpolicycenter	annenbergpublicpolicycenter.org	-1
ipu	ipu.org	-1
surveysystem	surveysystem.com	-1
harkavagrant	harkavagrant.com	-1
eetimes	eetimes.com	-1
newatlas	newatlas.com	-1
timeline	timeline.com	-1
encrypted-tbn1	encrypted-tbn1.gstatic.com	-1
taooftomo	taooftomo.com	-1
nutritionix	nutritionix.com	-1
prevention	prevention.com	-1
randi	web.randi.org	-1
wtop	wtop.com	-1
publish	publish.twitter.com	-1
scirp	file.scirp.org	-1
mamamia	mamamia.com.au	-1
ieeexplore	ieeexplore.ieee.org	-1
stanforddaily	stanforddaily.com	-1
themuse	themuse.com	-1
religiondispatches	religiondispatches.org	-1
thebluereview	thebluereview.net	-1
qld	qld.gov.au	-1
studybreaks	studybreaks.com	-1
guinnessworldrecords	guinnessworldrecords.com	-1
metrotimes	metrotimes.com	-1
fairplayforwomen	fairplayforwomen.com	-1
earlymoderntexts	earlymoderntexts.com	-1
thousandcurrents	thousandcurrents.org	-1
clutchmagonline	clutchmagonline.com	-1
earthlings	earthlings.com	-1
wapo	wapo.st	-1
ssir	ssir.org	-1
rspca	rspca.org.uk	-1
thinkinghousewife	thinkinghousewife.com	-1
constituteproject	constituteproject.org	-1
mdedge	mdedge.com	-1
ehealthinsurance	ehealthinsurance.com	-1
brainfacts	brainfacts.org	-1
madison	host.madison.com	-1
mayoclinicproceedings	mayoclinicproceedings.org	-1
askamathematician	askamathematician.com	-1
techjunkie	techjunkie.com	-1
useconomy	useconomy.about.com	-1
list25	list25.com	-1
bankofcanada	bankofcanada.ca	-1
aaup	aaup.org	-1
thisismoney	thisismoney.co.uk	-1
mshcdn	rack.2.mshcdn.com	-1
circinfo	circinfo.net	-1
freedomofmind	freedomofmind.com	-1
mountvernon	mountvernon.org	-1
democraticunderground	democraticunderground.com	-1
kipp	kipp.org	-1
minnesota	minnesota.cbslocal.com	-1
coindesk	coindesk.com	-1
americanheritage	americanheritage.com	-1
lozierinstitute	lozierinstitute.org	-1
careerbuilder	careerbuilder.com	-1
lagriffedulion	lagriffedulion.f2s.com	-1
zachmortensen	zachmortensen.net	-1
ndss	ndss.org	-1
mindbodygreen	mindbodygreen.com	-1
constitutionparty	constitutionparty.com	-1
postandcourier	postandcourier.com	-1
wellcome	wellcome.ac.uk	-1
fightthenewdrug	fightthenewdrug.org	-1
dst	dst.dk	-1
catholiceducation	catholiceducation.org	-1
loweringthebar	loweringthebar.net	-1
socialistworker	socialistworker.org	-1
magazine	magazine.good.is	-1
thevenusproject	thevenusproject.com	-1
masslive	masslive.com	-1
stephenjaygould	stephenjaygould.org	-1
feministfrequency	feministfrequency.com	-1
opensocietyfoundations	opensocietyfoundations.org	-1
criminal-law	criminal-law.freeadvice.com	-1
theepochtimes	theepochtimes.com	-1
verdantlabs	verdantlabs.com	-1
corporatefinanceinstitute	corporatefinanceinstitute.com	-1
simpletoremember	simpletoremember.com	-1
photius	photius.com	-1
encrypted-tbn2	encrypted-tbn2.gstatic.com	-1
thebestschools	thebestschools.org	-1
mpaa	mpaa.org	-1
pop	pop.org	-1
openparliament	openparliament.ca	-1
varsity	nca.varsity.com	-1
spokesman	spokesman.com	-1
networkworld	networkworld.com	-1
volunteermatch	volunteermatch.org	-1
avvo	avvo.com	-1
paypal	paypal.me	-1
whyy	whyy.org	-1
desmos	desmos.com	-1
sapiens	sapiens.org	-1
destatis	destatis.de	-1
samefacts	samefacts.com	-1
pdfserver	pdfserver.amlaw.com	-1
nownys	nownys.org	-1
bma	bma.org.uk	-1
commonslibrary	commonslibrary.parliament.uk	-1
professionals	professionals.collegeboard.org	-1
hyperallergic	hyperallergic.com	-1
crimepreventionresearchcenter	crimepreventionresearchcenter.org	-1
ijr	ijr.com	-1
phonearena	phonearena.com	-1
swampland	swampland.time.com	-1
slideplayer	images.slideplayer.com	-1
sciencing	sciencing.com	-1
apmreports	apmreports.org	-1
chartsbin	chartsbin.com	-1
python	docs.python.org	-1
hellointernet	hellointernet.fm	-1
wellandgood	wellandgood.com	-1
lwhasten	lwhasten.com	-1
brandonsanderson	brandonsanderson.com	-1
aviationweek	aviationweek.com	-1
grammarist	grammarist.com	-1
nba	nba.com	-1
divorcenet	divorcenet.com	-1
kgw	kgw.com	-1
prisonstudies	prisonstudies.org	-1
ecs	ecs.org	-1
iands	iands.es	-1
abanet	abanet.org	-1
gatesnotes	gatesnotes.com	-1
crunchyroll	crunchyroll.com	-1
equalityhumanrights	equalityhumanrights.com	-1
ebayimg	i.ebayimg.com	-1
debt	debt.org	-1
d25d2506sfb94s	d25d2506sfb94s.cloudfront.net	-1
txdps	txdps.state.tx.us	-1
radaronline	radaronline.com	-1
nbcbayarea	nbcbayarea.com	-1
polytechnic	faculty.polytechnic.org	-1
cheaperthandirt	blog.cheaperthandirt.com	-1
theatlas	theatlas.com	-1
adc	adc.bmj.com	-1
theenergycollective	theenergycollective.com	-1
treaties	treaties.un.org	-1
darwinawards	darwinawards.com	-1
hln	hln.be	-1
digitaldreamdoor	digitaldreamdoor.com	-1
snaptohealth	snaptohealth.org	-1
dell	dell.com	-1
asiaone	asiaone.com	-1
c4ss	c4ss.org	-1
povertyactionlab	povertyactionlab.org	-1
druglibrary	druglibrary.org	-1
ziprecruiter	ziprecruiter.com	-1
sacred-texts	sacred-texts.com	-1
stream1	stream1.gifsoup.com	-1
learnliberty	learnliberty.org	-1
store	store.usps.com	-1
myfox8	myfox8.com	-1
afterabortion	afterabortion.org	-1
eatright	eatright.org	-1
freefromharm	freefromharm.org	-1
rarehistoricalphotos	rarehistoricalphotos.com	-1
whicdn	data3.whicdn.com	-1
effectiviology	effectiviology.com	-1
trulia	trulia.com	-1
danielpipes	danielpipes.org	-1
hubpages	drbj.hubpages.com	-1
icij	icij.org	-1
sciencefocus	sciencefocus.com	-1
clarissethorn	clarissethorn.com	-1
mpp	mpp.org	-1
imageshack	img137.imageshack.us	-1
kevinmd	kevinmd.com	-1
newint	newint.org	-1
skysports	www1.skysports.com	-1
ethosreview	ethosreview.org	-1
els-cdn	ac.els-cdn.com	-1
9to5mac	9to5mac.com	-1
gameofthrones	gameofthrones.wikia.com	-1
earth-policy	earth-policy.org	-1
hechingerreport	hechingerreport.org	-1
makeagif	makeagif.com	-1
strawpoll	strawpoll.me	-1
citizen	citizen.co.za	-1
betterhealth	betterhealth.vic.gov.au	-1
electowiki	electowiki.org	-1
colleges	colleges.niche.com	-1
scq	scq.ubc.ca	-1
developer	developer.apple.com	-1
nationalpartnership	nationalpartnership.org	-1
electionbettingodds	electionbettingodds.com	-1
elpais	elpais.com	-1
elsevier	elsevier.com	-1
themuslimissue	themuslimissue.wordpress.com	-1
thetab	thetab.com	-1
christianity	christianity.com	-1
earthsky	earthsky.org	-1
madinamerica	madinamerica.com	-1
peterkreeft	peterkreeft.com	-1
indigenousfoundations	indigenousfoundations.arts.ubc.ca	-1
lawandthemultiverse	lawandthemultiverse.com	-1
rescue	rescue.org	-1
community	community.elca.org	-1
grossmanacademy	grossmanacademy.com	-1
libguides	canberra.libguides.com	-1
copblock	copblock.org	-1
starbucks	starbucks.com	-1
guns-vs-homicide	guns-vs-homicide.github.io	-1
krgv	m.krgv.com	-1
anncoulter	anncoulter.com	-1
vdare	vdare.com	-1
scholarpedia	scholarpedia.org	-1
loonwatch	loonwatch.com	-1
equalitytrust	equalitytrust.org.uk	-1
aec	aec.gov.au	-1
acton	blog.acton.org	-1
vetjournal	vetjournal.it	-1
hcn	hcn.org	-1
medicare	medicare.ie	-1
family-law	family-law.freeadvice.com	-1
profam	profam.org	-1
nationalseedproject	nationalseedproject.org	-1
cultural-misandry	cultural-misandry.com	-1
secure	ecs.secure.force.com	-1
withouthotair	withouthotair.com	-1
survivalinternational	survivalinternational.org	-1
harrisinteractive	harrisinteractive.com	-1
alibaba	m.alibaba.com	-1
abc7ny	abc7ny.com	-1
leagle	leagle.com	-1
let	let.rug.nl	-1
indy100	indy100.com	-1
upjohn	upjohn.org	-1
addictioncenter	addictioncenter.com	-1
thehearttruths	thehearttruths.files.wordpress.com	-1
humanosphere	humanosphere.org	-1
gog	gog.com	-1
techradar	techradar.com	-1
nssf	nssf.org	-1
outdoorhub	outdoorhub.com	-1
izismile	img.izismile.com	-1
scotsman	scotsman.com	-1
rhrealitycheck	rhrealitycheck.org	-1
jsexmed	jsm.jsexmed.org	-1
thefix	thefix.com	-1
cpr	cpr.org	-1
nakedcapitalism	nakedcapitalism.com	-1
kansas	kansas.com	-1
andrewleigh	andrewleigh.org	-1
asiafoundation	asiafoundation.org	-1
boxedwaterisbetter	boxedwaterisbetter.com	-1
patreon	patreon.com	-1
lapatilla	lapatilla.com	-1
townandcountrymag	townandcountrymag.com	-1
osgata	osgata.org	-1
caffeineinformer	caffeineinformer.com	-1
neatorama	static.neatorama.com	-1
minitab	blog.minitab.com	-1
qwantz	qwantz.com	-1
thepostmillennial	thepostmillennial.com	-1
thrivenotes	thrivenotes.com	-1
corpus	corpus.quran.com	-1
civilliberty	civilliberty.about.com	-1
andrewsullivan	dish.andrewsullivan.com	-1
laist	laist.com	-1
ar500armor	ar500armor.com	-1
vetstreet	vetstreet.com	-1
upmc	upmc.com	-1
globalfirepower	globalfirepower.com	-1
hubspot	cdn2.hubspot.net	-1
amnh	amnh.org	-1
digitalspy	digitalspy.com	-1
tnellen	tnellen.com	-1
spglobal	spglobal.com	-1
preposterousuniverse	preposterousuniverse.com	-1
ottawacitizen	ottawacitizen.com	-1
bmcpsychiatry	bmcpsychiatry.biomedcentral.com	-1
healthcentral	healthcentral.com	-1
nikkei	asia.nikkei.com	-1
scottsantens	scottsantens.com	-1
falkvinge	falkvinge.net	-1
justdetention	justdetention.org	-1
richarddawkins	richarddawkins.net	-1
ditext	ditext.com	-1
pioneer	pioneer.com	-1
childrenshospital	childrenshospital.org	-1
vegetariantimes	vegetariantimes.com	-1
jamieoliver	jamieoliver.com	-1
tenor	c.tenor.com	-1
wsbtv	wsbtv.com	-1
jewfaq	jewfaq.org	-1
aier	aier.org	-1
autoblog	autoblog.com	-1
wwf	wwf.de	-1
humanevents	humanevents.com	-1
r-word	r-word.org	-1
business-humanrights	business-humanrights.org	-1
accesstoinsight	accesstoinsight.org	-1
adoptionnetwork	adoptionnetwork.com	-1
danielmiessler	danielmiessler.com	-1
pando	pando.com	-1
reddithelp	reddithelp.com	-1
votingrights	votingrights.news21.com	-1
eewc	eewc.com	-1
playoverwatch	playoverwatch.com	-1
blackenterprise	blackenterprise.com	-1
the-american-interest	the-american-interest.com	-1
fritolay	fritolay.com	-1
gannett-cdn	gannett-cdn.com	-1
ftalphaville	ftalphaville.ft.com	-1
media-cache-ak0	media-cache-ak0.pinimg.com	-1
unwatch	unwatch.org	-1
thingofthings	thingofthings.wordpress.com	-1
businessdictionary	businessdictionary.com	-1
palmbeachpost	palmbeachpost.com	-1
revelist	revelist.com	-1
rameznaam	rameznaam.com	-1
delish	delish.com	-1
ScoreVoting	ScoreVoting.net	-1
wcpo	wcpo.com	-1
gamelengths	gamelengths.com	-1
trustvote	trustvote.org	-1
iifym	iifym.com	-1
islam101	islam101.com	-1
rentjungle	rentjungle.com	-1
cironline	cironline.org	-1
abclocal	abclocal.go.com	-1
controlled-demolition	controlled-demolition.com	-1
gamapserver	gamapserver.who.int	-1
afer	afer.org	-1
americanscientist	americanscientist.org	-1
republic	republic.org.uk	-1
vibe	vibe.com	-1
worldstarhiphop	worldstarhiphop.com	-1
asnjournals	cjasn.asnjournals.org	-1
physlink	physlink.com	-1
toptenz	toptenz.net	-1
utilitydive	utilitydive.com	-1
churchofjesuschrist	churchofjesuschrist.org	-1
dissentmagazine	dissentmagazine.org	-1
skeptic	skeptic.com	-1
trid	trid.trb.org	-1
usma	usma.org	-1
badassdigest	badassdigest.com	-1
pride-flags	pride-flags.deviantart.com	-1
returnofkings	returnofkings.com	-1
cancercouncil	cancercouncil.com.au	-1
itsgoingdown	itsgoingdown.org	-1
legionathletics	legionathletics.com	-1
energyfromthorium	energyfromthorium.com	-1
flibe-energy	flibe-energy.com	-1
nextshark	nextshark.com	-1
suite	suite.io	-1
msf	msf.org	-1
sfu	sfu.ca	-1
spacex	spacex.com	-1
eatocracy	eatocracy.cnn.com	-1
the-orbit	the-orbit.net	-1
hdnux	ww3.hdnux.com	-1
deathandtaxesmag	deathandtaxesmag.com	-1
therecord	therecord.com	-1
walmartimages	i5.walmartimages.com	-1
1in6	1in6.org	-1
endocrine-abstracts	endocrine-abstracts.org	-1
capitalresearch	capitalresearch.org	-1
foodispower	foodispower.org	-1
joedubs	joedubs.com	-1
healthblog	healthblog.uofmhealth.org	-1
confex	apha.confex.com	-1
raisetheminimumwage	raisetheminimumwage.com	-1
gunmemorial	gunmemorial.org	-1
deloitte	www2.deloitte.com	-1
dutchrapporteur	dutchrapporteur.nl	-1
nss	nss.org	-1
blockchain	blockchain.info	-1
simplejustice	blog.simplejustice.us	-1
gstatic	t0.gstatic.com	-1
freedomforuminstitute	freedomforuminstitute.org	-1
cbsistatic	cbsnews1.cbsistatic.com	-1
futureofchildren	futureofchildren.org	-1
ala	ala.org	-1
ncregister	m.ncregister.com	-1
nonprofitquarterly	nonprofitquarterly.org	-1
iol	iol.co.za	-1
equalitynow	equalitynow.org	-1
media-cache-ec0	media-cache-ec0.pinimg.com	-1
stakeholders	stakeholders.ofcom.org.uk	-1
defacingcurrency	defacingcurrency.files.wordpress.com	-1
immunize	immunize.org	-1
statcounter	gs.statcounter.com	-1
mckinleyirvin	mckinleyirvin.com	-1
hightimes	hightimes.com	-1
mentalhealthamerica	mentalhealthamerica.net	-1
coop	geo.coop	-1
tiktok	vm.tiktok.com	-1
darpa	darpa.mil	-1
learnersdictionary	learnersdictionary.com	-1
tvguide	tvguide.com	-1
theatlanticcities	theatlanticcities.com	-1
policingequity	policingequity.org	-1
acas	acas.org.uk	-1
kxan	kxan.com	-1
heartland	blog.heartland.org	-1
insightcrime	insightcrime.org	-1
blacknerdproblems	blacknerdproblems.com	-1
girlpowermarketing	girlpowermarketing.com	-1
wqad	wqad.com	-1
unstats	unstats.un.org	-1
galactanet	galactanet.com	-1
kiva	kiva.org	-1
fotoforensics	fotoforensics.com	-1
springerpub	connect.springerpub.com	-1
theecologist	theecologist.org	-1
random	random.org	-1
consumeraffairs	consumeraffairs.com	-1
stuartmcmillen	stuartmcmillen.com	-1
mil	au.af.mil	-1
active	active.com	-1
climatenexus	climatenexus.org	-1
drjengunter	drjengunter.wordpress.com	-1
peacemaker	peacemaker.un.org	-1
nbcdfw	nbcdfw.com	-1
cbn	cbn.com	-1
dailytech	dailytech.com	-1
jjmccullough	jjmccullough.com	-1
devex	devex.com	-1
minus	i.minus.com	-1
someecards	cdn.someecards.com	-1
explorable	explorable.com	-1
thorntons-law	thorntons-law.co.uk	-1
gr-assets	i.gr-assets.com	-1
edutopia	edutopia.org	-1
bossip	bossip.com	-1
grammarly	grammarly.com	-1
mrctv	mrctv.org	-1
bluelight	bluelight.org	-1
cspinet	cspinet.org	-1
marvelcinematicuniverse	marvelcinematicuniverse.wikia.com	-1
craigslist	sfbay.craigslist.org	-1
Ancestry	Ancestry.com	-1
marxist	marxist.com	-1
calorielab	calorielab.com	-1
tqn	0.tqn.com	-1
bignam	bignam.org	-1
theness	theness.com	-1
scouting	scouting.org	-1
pegc	pegc.us	-1
thepsychologist	thepsychologist.bps.org.uk	-1
nato	nato.int	-1
everybodysolar	everybodysolar.org	-1
powermag	powermag.com	-1
psycom	psycom.net	-1
truthorfiction	truthorfiction.com	-1
bitchmedia	bitchmedia.org	-1
aaha	aaha.org	-1
thenewprogressive	thenewprogressive.net	-1
properalism	properalism.blogspot.com	-1
smith-wesson	smith-wesson.com	-1
bl	bl.uk	-1
encrypted-tbn3	encrypted-tbn3.gstatic.com	-1
bethematch	bethematch.org	-1
therationalmale	therationalmale.com	-1
dbsalliance	dbsalliance.org	-1
dollarsandsense	dollarsandsense.sg	-1
photographyisnotacrime	photographyisnotacrime.com	-1
angryharry	angryharry.com	-1
jstage	jstage.jst.go.jp	-1
uslegal	courts.uslegal.com	-1
boards	boards.4chan.org	-1
weeklysift	weeklysift.com	-1
mindingthecampus	mindingthecampus.org	-1
iata	iata.org	-1
thenewcivilrightsmovement	thenewcivilrightsmovement.com	-1
goingfaster	goingfaster.com	-1
androidpolice	androidpolice.com	-1
healthycommunitieshealthyfuture	healthycommunitieshealthyfuture.org	-1
welt	welt.de	-1
freethinker	freethinker.co.uk	-1
pajiba	pajiba.com	-1
codinghorror	blog.codinghorror.com	-1
henrikkleven	henrikkleven.com	-1
soapboxie	soapboxie.com	-1
philochristos	philochristos.blogspot.com	-1
stephenhicks	stephenhicks.org	-1
mediaradar	mediaradar.org	-1
vera	vera.org	-1
electorama	wiki.electorama.com	-1
southernnevadahealthdistrict	covid.southernnevadahealthdistrict.org	-1
legaldictionary	legaldictionary.net	-1
santafenewmexican	santafenewmexican.com	-1
bcg	bcg.com	-1
oneangrygamer	oneangrygamer.net	-1
nhchc	nhchc.org	-1
babyreference	babyreference.com	-1
westegg	westegg.com	-1
static1	static1.srcdn.com	-1
newdualism	newdualism.org	-1
adaptt	adaptt.org	-1
newmalecontraception	newmalecontraception.org	-1
chainsawsuit	chainsawsuit.com	-1
transformdrugs	transformdrugs.org	-1
ncsc	ncsc.org	-1
indiatoday	indiatoday.intoday.in	-1
972mag	972mag.com	-1
whole-dog-journal	whole-dog-journal.com	-1
dnainfo	dnainfo.com	-1
alz	alz.org	-1
corpwatch	corpwatch.org	-1
biblica	biblica.com	-1
freedomainradio	cdn.media.freedomainradio.com	-1
4chan	4chan.org	-1
whyislam	whyislam.org	-1
ge	ge.tt	-1
trutv	trutv.com	-1
humanparts	humanparts.medium.com	-1
thumbor	thumbor.forbes.com	-1
rockinst	rockinst.org	-1
torontolife	torontolife.com	-1
activistpost	activistpost.com	-1
gawkerassets	img.gawkerassets.com	-1
consilium	consilium.europa.eu	-1
khou	khou.com	-1
abrahamlincolnonline	abrahamlincolnonline.org	-1
carnegieendowment	carnegieendowment.org	-1
www-nytimes-com	www-nytimes-com.cdn.ampproject.org	-1
11alive	11alive.com	-1
vhemt	vhemt.org	-1
secure-media	secure-media.collegeboard.org	-1
academicjournals	academicjournals.org	-1
ireport	ireport.cnn.com	-1
thecommentator	thecommentator.com	-1
thecaucus	thecaucus.blogs.nytimes.com	-1
justfactsdaily	justfactsdaily.com	-1
apartmentlist	apartmentlist.com	-1
haveibeenpwned	haveibeenpwned.com	-1
federal-budget	federal-budget.insidegov.com	-1
sourceforge	audacity.sourceforge.net	-1
nationalobserver	nationalobserver.com	-1
partners	partners.nytimes.com	-1
veganuary	veganuary.com	-1
jpeds	jpeds.com	-1
minecraft	minecraft.gamepedia.com	-1
blizzard	us.blizzard.com	-1
periscopic	terror.periscopic.com	-1
nsfwyoutube	nsfwyoutube.com	-1
nhm	nhm.ac.uk	-1
forgottenrealms	forgottenrealms.fandom.com	-1
over-blog-kiwi	img.over-blog-kiwi.com	-1
fansided	fansided.com	-1
habitat	habitat.ca	-1
stjude	stjude.org	-1
elsiehui	elsiehui.com	-1
chessbase	en.chessbase.com	-1
collider	collider.com	-1
greatist	greatist.com	-1
worldvaluessurvey	worldvaluessurvey.org	-1
justjared	cdn01.cdn.justjared.com	-1
calorieking	calorieking.com	-1
edsource	edsource.org	-1
ems1	ems1.com	-1
mensjournal	mensjournal.com	-1
chicagobusiness	chicagobusiness.com	-1
andrewbostom	andrewbostom.org	-1
economicoutlook	bilbo.economicoutlook.net	-1
efile	efile.com	-1
crin	crin.org	-1
firearmsandliberty	firearmsandliberty.com	-1
mynorthwest	mynorthwest.com	-1
ccrjustice	ccrjustice.org	-1
cedro-uva	cedro-uva.org	-1
nme	nme.com	-1
prwatch	prwatch.org	-1
gunsandammo	gunsandammo.com	-1
heatst	heatst.com	-1
crisis	crisis.org.cn	-1
daveramsey	daveramsey.com	-1
sipri	sipri.org	-1
zippia	zippia.com	-1
andrewgelman	andrewgelman.com	-1
quorum	quorum.us	-1
edx	edx.org	-1
kare11	kare11.com	-1
naacpldf	naacpldf.org	-1
discogs	discogs.com	-1
politicalticker	politicalticker.blogs.cnn.com	-1
fox6now	fox6now.com	-1
skyandtelescope	skyandtelescope.com	-1
globalinnovationindex	globalinnovationindex.org	-1
downtrend	downtrend.com	-1
acslaw	acslaw.org	-1
redcross	redcross.org	-1
cartercenter	cartercenter.org	-1
hiddenincatours	hiddenincatours.com	-1
openknowledge	openknowledge.worldbank.org	-1
expertlaw	expertlaw.com	-1
openpsychometrics	openpsychometrics.org	-1
billionbibles	billionbibles.org	-1
interglacial	interglacial.com	-1
anepigone	anepigone.blogspot.com	-1
aft	aft.org	-1
nationalmemo	nationalmemo.com	-1
bandcamp	bandcamp.com	-1
peteforamerica	peteforamerica.com	-1
anarchism	anarchism.pageabode.com	-1
havocscope	havocscope.com	-1
nbc	nbc.com	-1
astronomy	astronomy.com	-1
etonline	etonline.com	-1
oxfordre	oxfordre.com	-1
mindyourdecisions	mindyourdecisions.com	-1
chipotle	ir.chipotle.com	-1
americanaffairsjournal	americanaffairsjournal.org	-1
wondermark	wondermark.com	-1
hulu	hulu.com	-1
theduluthmodel	theduluthmodel.org	-1
mpoweruk	mpoweruk.com	-1
sparkpeople	sparkpeople.com	-1
amsciepub	amsciepub.com	-1
costco	www2.costco.com	-1
goodrx	goodrx.com	-1
chicagonow	chicagonow.com	-1
tierneylab	tierneylab.blogs.nytimes.com	-1
survivalafterdeath	survivalafterdeath.info	-1
frontporchrepublic	frontporchrepublic.com	-1
trucks	trucks.com	-1
rtings	rtings.com	-1
sole-jole	sole-jole.org	-1
dominionmovement	dominionmovement.com	-1
asirt	asirt.org	-1
tafp	tafp.org	-1
subsidytracker	subsidytracker.goodjobsfirst.org	-1
expatica	expatica.com	-1
moneychimp	moneychimp.com	-1
expatistan	expatistan.com	-1
thesmokinggun	thesmokinggun.com	-1
degruyter	degruyter.com	-1
ecology	ecology.com	-1
michellemalkin	michellemalkin.com	-1
grubstreet	grubstreet.com	-1
exploringthemind	exploringthemind.com	-1
nagc	nagc.org	-1
indianapublicmedia	indianapublicmedia.org	-1
glamourmagazine	glamourmagazine.co.uk	-1
obamacarefacts	obamacarefacts.com	-1
americansforprosperity	americansforprosperity.org	-1
westernjournal	westernjournal.com	-1
dresdencodak	dresdencodak.com	-1
immigration	immigration.procon.org	-1
philosophyexperiments	philosophyexperiments.com	-1
joemygod	joemygod.blogspot.com	-1
aihw	aihw.gov.au	-1
thriveglobal	thriveglobal.com	-1
d20pfsrd	d20pfsrd.com	-1
thehealthyhomeeconomist	thehealthyhomeeconomist.com	-1
owlcation	owlcation.com	-1
anad	anad.org	-1
transgenderlaw	transgenderlaw.org	-1
cars	cars.com	-1
measuringworth	measuringworth.com	-1
cnnpressroom	cnnpressroom.blogs.cnn.com	-1
idea	idea.int	-1
cjcj	cjcj.org	-1
spin	spin.com	-1
highprogrammer	highprogrammer.com	-1
bepress	works.bepress.com	-1
eluniversal	archivo.eluniversal.com.mx	-1
historycentral	historycentral.com	-1
tobaccofreekids	tobaccofreekids.org	-1
bechdeltest	bechdeltest.com	-1
ndtv	ndtv.com	-1
etsy	etsy.com	-1
meta	meta.ath0.com	-1
cityobservatory	cityobservatory.org	-1
civilwarcauses	civilwarcauses.org	-1
classroom	classroom.synonym.com	-1
fidelity	fidelity.com	-1
colorofcrime	colorofcrime.com	-1
bradfordtaxinstitute	bradfordtaxinstitute.com	-1
venganza	venganza.org	-1
cntraveler	cntraveler.com	-1
judithcurry	judithcurry.com	-1
4plebs	img.4plebs.org	-1
catbox	files.catbox.moe	-1
sportsmediawatch	sportsmediawatch.com	-1
researchbriefings	researchbriefings.files.parliament.uk	-1
redditmetrics	redditmetrics.com	-1
hrblock	hrblock.com	-1
quanthockey	quanthockey.com	-1
cyberbullying	cyberbullying.org	-1
multivax	multivax.com	-1
govt	moh.govt.nz	-1
good	good.is	-1
cnbcfm	sc.cnbcfm.com	-1
artnet	artnet.com	-1
asam	asam.org	-1
interactioninstitute	interactioninstitute.org	-1
motortrend	motortrend.com	-1
drugfreeworld	drugfreeworld.org	-1
stories	stories.avvo.com	-1
washingtonian	washingtonian.com	-1
airforcetimes	archive.airforcetimes.com	-1
steemit	steemit.com	-1
mymodernmet	mymodernmet.com	-1
gigaom	gigaom.com	-1
arktimes	arktimes.com	-1
thesatanictemple	thesatanictemple.com	-1
pewstates	pewstates.org	-1
pamelageller	pamelageller.com	-1
humanprogress	humanprogress.org	-1
popcenter	popcenter.org	-1
americanrhetoric	americanrhetoric.com	-1
greatveganathletes	greatveganathletes.com	-1
wweek	wweek.com	-1
volvocars	new.volvocars.com	-1
reddituploads	i.reddituploads.com	-1
ulwaluko	ulwaluko.co.za	-1
educationdata	educationdata.org	-1
galegroup	ic.galegroup.com	-1
whio	whio.com	-1
pcgamesn	pcgamesn.com	-1
level3	blog.level3.com	-1
permutationofninjas	permutationofninjas.org	-1
bicycling	bicycling.com	-1
meduniwien	meduniwien.ac.at	-1
1drv	1drv.ms	-1
mining	mining.com	-1
rspb	rspb.org.uk	-1
desiringgod	desiringgod.org	-1
ic	ic.gc.ca	-1
claimsjournal	claimsjournal.com	-1
miaminewtimes	miaminewtimes.com	-1
evolution-outreach	evolution-outreach.biomedcentral.com	-1
marriage	marriage.uslegal.com	-1
metapedia	en.metapedia.org	-1
explosm	explosm.net	-1
historytoday	historytoday.com	-1
zerotothree	zerotothree.org	-1
cpusa	cpusa.org	-1
seatguru	seatguru.com	-1
adblockplus	adblockplus.org	-1
vaccinepapers	vaccinepapers.org	-1
ssbwiki	ssbwiki.com	-1
ebony	ebony.com	-1
niche	niche.com	-1
abuaminaelias	abuaminaelias.com	-1
understandingprejudice	understandingprejudice.org	-1
transgendertrend	transgendertrend.com	-1
irena	irena.org	-1
fangraphs	tht.fangraphs.com	-1
strangenotions	strangenotions.com	-1
vgchartz	vgchartz.com	-1
link	link.gale.com	-1
refworld	refworld.org	-1
topendsports	topendsports.com	-1
righteousmind	righteousmind.com	-1
dw	dw.de	-1
distractify	news.distractify.com	-1
nakedsecurity	nakedsecurity.sophos.com	-1
oddschecker	oddschecker.com	-1
agric	agric.wa.gov.au	-1
dummies	dummies.com	-1
thehomegunsmith	thehomegunsmith.com	-1
nationalreport	nationalreport.net	-1
powerliftingwatch	powerliftingwatch.com	-1
michaelshermer	michaelshermer.com	-1
physoc	physoc.org	-1
policyinnovations	policyinnovations.org	-1
republicreport	republicreport.org	-1
baseball-reference	baseball-reference.com	-1
nyagv	nyagv.org	-1
chegg	chegg.com	-1
cpa	cpa.ca	-1
timebusinessblog	timebusinessblog.files.wordpress.com	-1
greenbiz	greenbiz.com	-1
ewtn	ewtn.com	-1
canberra	aerg.canberra.edu.au	-1
hdot	hdot.org	-1
regjeringen	regjeringen.no	-1
bostonfairhousing	bostonfairhousing.org	-1
eurostat	appsso.eurostat.ec.europa.eu	-1
the-sun	the-sun.com	-1
ihr	ihr.org	-1
gladwell	gladwell.com	-1
fourmilab	fourmilab.ch	-1
gvpedia	gvpedia.org	-1
lambdalegal	lambdalegal.org	-1
prostitution	prostitution.procon.org	-1
svt	svt.se	-1
ascopubs	jco.ascopubs.org	-1
ourfuture	ourfuture.org	-1
bitnation	bitnation.co	-1
fox59	fox59.com	-1
bikeleague	bikeleague.org	-1
neatoday	neatoday.org	-1
changetip	changetip.com	-1
21stcentech	21stcentech.com	-1
timothy-judge	timothy-judge.com	-1
religionfacts	religionfacts.com	-1
freerangekids	freerangekids.com	-1
norc	gss.norc.org	-1
ctj	ctj.org	-1
job-openings	job-openings.monster.com	-1
thechart	thechart.blogs.cnn.com	-1
apologeticspress	apologeticspress.org	-1
wftv	wftv.com	-1
guernicamag	guernicamag.com	-1
zolarenergy	zolarenergy.net	-1
csom	csom.org	-1
islamicsupremecouncil	islamicsupremecouncil.org	-1
china	china.org.cn	-1
freedom-dividend	freedom-dividend.com	-1
johanneskopf	johanneskopf.de	-1
avert	avert.org	-1
coha	coha.org	-1
details	details.com	-1
conceptart	conceptart.org	-1
politicalparity	politicalparity.org	-1
policeviolencereport	policeviolencereport.org	-1
atlasobscura	atlasobscura.com	-1
onthemedia	onthemedia.org	-1
bicyclinglife	bicyclinglife.com	-1
anonymousus	anonymousus.org	-1
manboobz	manboobz.com	-1
ikea	ikea.com	-1
frbatlanta	frbatlanta.org	-1
bjui-journals	bjui-journals.onlinelibrary.wiley.com	-1
adoption	adoption.com	-1
iris	iris.ucl.ac.uk	-1
tolkiengateway	tolkiengateway.net	-1
centerforinquiry	ns2.centerforinquiry.net	-1
childrensrights	childrensrights.org	-1
petiscos	petiscos.com	-1
alllaw	alllaw.com	-1
digilander	digilander.libero.it	-1
reminddit	reminddit.com	-1
d1wqtxts1xzle7	d1wqtxts1xzle7.cloudfront.net	-1
ageofconsent	ageofconsent.net	-1
nomachetejuggling	nomachetejuggling.com	-1
vegan	vegan.org	-1
thegwpf	thegwpf.com	-1
houseofnames	houseofnames.com	-1
opsgear	opsgear.com	-1
