short domain	long domain	label
reddit	reddit	sm
wikipedia	en.wikipedia	sci,g
youtube	youtube	sm,g
google	google	g
ncbi	ncbi.nlm.nih	sci
youtu	youtu.be	sm,g
imgur	imgur	g
nytimes	nytimes	news
washingtonpost	washingtonpost	news
theguardian	theguardian	news
cdc	cdc	sci
npr	npr	news
forbes	forbes	news
huffingtonpost	huffingtonpost	news
theatlantic	theatlantic	news
pastebin	pastebin	o
cnn	cnn	news
bbc	bbc	news
amazon	amazon	commerce
github	github	git
businessinsider	businessinsider.nl	news
vox	vox	news
who	who.int	sci
pewresearch	pewresearch	sci
politifact	politifact	fact
wikimedia	upload.wikimedia	sci,g
sciencedirect	sciencedirect	sci
merriam-webster	merriam-webster	dict,g
stanford	plato.stanford	sci
psychologytoday	psychologytoday	sci,news
scientificamerican	scientificamerican	sci
twitter	twitter	sm
slate	slate	news
independent	independent.co.uk	news
journals	journals.ametsoc	sci
nature	nature	sci
gallup	gallup	sci
harvard	hms.harvard	sci
time	time	news
nbcnews	usnews.nbcnews	news
fivethirtyeight	fivethirtyeight	news
onlinelibrary	spssi.onlinelibrary.wiley	sci
usatoday	usatoday	news
archive	web.archive	g
dailymail	i.dailymail.co.uk	news
nber	nber	sci
telegraph	telegraph.co.uk	news
dictionary	dictionary	dict,g
cornell	law.cornell	sci
politico	politico	news
reuters	reuters	news
cbsnews	cbsnews	news
springer	link.springer	sci
cnbc	cnbc	news
mozilla	addons.mozilla	g
bls	bls	sci
statista	statista	sci
greasyfork	greasyfork	o
abcnews	abcnews.go	news
sciencedaily	sciencedaily	news,sci
apa	apa	sci
medium	medium	sm,g
pbs	pbs	news
researchgate	researchgate	sci
bjs	bjs	sci
economist	economist	news
news	news	news
latimes	latimes	news
wsj	wsj	news
livescience	livescience	sci,news
xkcd	xkcd	humor
scholar	scholar.harvard	sci
thehill	thehill	news
census	census	sci
pnas	pnas	sci
ted	ted	sci,g
bloomberg	bloomberg	news
snopes	snopes	fact
pewforum	pewforum	sci
pubmed	pubmed.ncbi.nlm.nih	sci
chrome	chrome.google	g
newsweek	newsweek	news
webmd	webmd	sci
usnews	money.usnews	news
huffpost	m.huffpost	news
investopedia	investopedia	news
ourworldindata	ourworldindata	sci,news
redditenhancementsuite	redditenhancementsuite	sm
ucr	ucr.fbi	sci
brookings	brookings	sci
blogspot	4.bp.blogspot	o
quora	quora	sm,g
fbi	fbi	gov
motherjones	motherjones	news
money	money.cnn	news
realclearpolitics	realclearpolitics	news
tvtropes	static.tvtropes	humor
nationalgeographic	news.nationalgeographic	news,sci
tandfonline	tandfonline	sci
jstor	jstor	sci
sciencemag	sciencemag	sci
thinkprogress	thinkprogress	news
aappublications	pediatrics.aappublications	sci
biblegateway	biblegateway	source
cbc	cbc.ca	news
slatestarcodex	slatestarcodex	sci,blog
nypost	nypost	news
foxnews	foxnews	news
washingtontimes	washingtontimes	news
newyorker	newyorker	news
imdb	imdb	source
wired	wired	news
rationalwiki	rationalwiki	blog,sci
thedailybeast	thedailybeast	news
salon	salon	news
aclu	aclu	org
worldbank	data.worldbank	sci
reason	reason	news
qz	qz	news
newscientist	newscientist	news,sci
rainn	rainn	o
nces	nces.ed	sci
oxforddictionaries	oxforddictionaries	dict
academic	academic.oup	sci
goo	goo.gl	g
epi	epi	o
justice	justice	org
stlouisfed	fredblog.stlouisfed	org,econ
nydailynews	nydailynews	news
fortune	fortune	source
igmchicago	igmchicago	sci
mayoclinic	mayoclinic	sci
papers	papers.ssrn	sci
apnews	apnews	news
nationalreview	nationalreview	news
guttmacher	guttmacher	org,sci
redd	i.redd.it	sm
heritage	heritage	org,sci
arstechnica	arstechnica	sci,news
lesswrong	lesswrong	blog,sci
history	history	o
un	un	org,sci
psy	psy	o
sagepub	ccr.sagepub	sci
britannica	britannica	fact
theconversation	theconversation	news,sci
factcheck	factcheck	fact
people-press	people-press	news
mises	mises	org,sci
vice	vice	news
princeton	press.princeton	sci
nymag	nymag	news
nhs	nhs.uk	sci
wordpress	quadriv.files.wordpress	blog
s-media-cache-ak0	s-media-cache-ak0.pinimg	o
healthline	healthline	sci
washingtonexaminer	washingtonexaminer	news
chicagotribune	chicagotribune	news
content	content.gallup	sci
freakonomics	freakonomics	sci,news
cato	cato	org,sci
climate	climate.nasa	sci,gov,org
deathpenaltyinfo	deathpenaltyinfo	org,sci
taxfoundation	taxfoundation	o
kff	kff	o
blogs	blogs.bmj	-1
breitbart	breitbart	-1
opensecrets	opensecrets	-1
aljazeera	aljazeera	-1
buzzfeed	buzzfeed	-1
pewsocialtrends	pewsocialtrends	-1
marketwatch	marketwatch	-1
ipcc	ipcc.ch	-1
dol	dol	-1
		-1
nejm	nejm	-1
smithsonianmag	smithsonianmag	-1
theintercept	theintercept	-1
stackexchange	skeptics.stackexchange	-1
theverge	theverge	-1
cracked	cracked	-1
hbr	hbr	-1
usda	fns.usda	-1
whatweknow	whatweknow.inequality.cornell	-1
skepticalscience	skepticalscience	-1
edition	edition.cnn	-1
goodreads	goodreads	-1
cps	cps	-1
articles	articles.latimes	-1
irs	irs	-1
smbc	smbc	-1
jam	jam	-1
data	data.oecd	-1
europa	ec.europa.eu	-1
fas	fas	-1
gov	gov.uk	-1
epa	epa	-1
yourlogicalfallacyis	yourlogicalfallacyis	-1
oxfordjournals	aje.oxfordjournals	-1
wiktionary	en.wiktionary	-1
whitehouse	whitehouse	-1
berkeley	eml.berkeley	-1
thenation	thenation	-1
tradingeconomics	tradingeconomics	-1
abc	abc	-1
drugabuse	archives.drugabuse	-1
americanprogress	americanprogress	-1
yahoo	news.yahoo	-1
tumblr	25.media.tumblr	-1
splcenter	splcenter	-1
cambridge	cambridge	-1
images	images.app.goo.gl	-1
fda	fda	-1
medicalnewstoday	medicalnewstoday	-1
hrw	hrw	-1
umich	law.umich	-1
cancer	cancer	-1
cbpp	cbpp	-1
ibtimes	ibtimes	-1
howstuffworks	science.howstuffworks	-1
propublica	propublica	-1
gizmodo	io9.gizmodo	-1
mic	mic	-1
dailykos	dailykos	-1
crimeresearch	crimeresearch	-1
rollingstone	rollingstone	-1
pinimg	i.pinimg	-1
phys	phys	-1
thefreedictionary	thefreedictionary	-1
ballotpedia	ballotpedia	-1
iep	iep.utm	-1
scholarship	scholarship.law.duke	-1
thelancet	thelancet	-1
eia	eia	-1
foreignpolicy	foreignpolicy	-1
ncjrs	ncjrs	-1
nasa	jpl.nasa	-1
g	g	-1
alte	alte	-1
weforum	weforum	-1
arxiv	arxiv	-1
nationmaster	nationmaster	-1
thisamericanlife	thisamericanlife	-1
williamsinstitute	williamsinstitute.law.ucla	-1
nap	nap	-1
newrepublic	newrepublic	-1
cbo	cbo	-1
nolo	nolo	-1
bostonglobe	bostonglobe	-1
rand	rand	-1
dailycaller	dailycaller	-1
everydayfeminism	everydayfeminism	-1
rt	rt	-1
oecd	oecd	-1
doi	doi	-1
insidehighered	insidehighered	-1
aei	aei	-1
knowyourmeme	knowyourmeme	-1
biblehub	biblehub	-1
colorado	colorado	-1
lmgtfy	lmgtfy	-1
taxpolicycenter	taxpolicycenter	-1
state	leg1.state.va.us	-1
theglobeandmail	theglobeandmail	-1
starwars	starwars.wikia	-1
espn	espn	-1
digita	digita	-1
ncsl	ncsl	-1
patheos	patheos	-1
seattletimes	seattletimes	-1
thebalance	thebalance	-1
vimeo	vimeo	-1
jezebel	jezebel	-1
msnbc	msnbc	-1
online	online.wsj	-1
pewglobal	pewglobal	-1
haaretz	haaretz.co.il	-1
nationalpost	nationalpost	-1
congress	congress	-1
plannedparenthood	plannedparenthood	-1
kym-cdn	i0.kym-cdn	-1
dailywire	dailywire	-1
today	today	-1
psychcentral	psychcentral	-1
nutrition	ajcn.nutrition	-1
urbandictionary	urbandictionary	-1
statcan	statcan.gc.ca	-1
ft	ft	-1
aeaweb	aeaweb	-1
medscape	medscape	-1
advocate	advocate	-1
amazonaws	s3.amazonaws	-1
payscale	payscale	-1
instagram	instagram	-1
ssa	ssa	-1
health	health.ny	-1
www1	www1.cbn	-1
fee	fee	-1
rbutr	rbutr	-1
cirp	cirp	-1
globalnews	globalnews.ca	-1
academia	academia	-1
www2	www2.ucsc	-1
aic	aic	-1
discovermagazine	blogs.discovermagazine	-1
etymonline	etymonline	-1
gawker	gawker	-1
ontheissues	ontheissues	-1
niaaa	pubs.niaaa.nih	-1
vanityfair	vanityfair	-1
findlaw	codes.lp.findlaw	-1
techcrunch	techcrunch	-1
cnsnews	cnsnews	-1
brennancenter	brennancenter	-1
semanticscholar	pdfs.semanticscholar	-1
voat	voat.co	-1
sci-hub	sci-hub.se	-1
washington	washington	-1
soundcloud	soundcloud	-1
msn	msn	-1
aphapublications	ajph.aphapublications	-1
commonwealthfund	commonwealthfund	-1
worldpopulationreview	worldpopulationreview	-1
citylab	citylab	-1
finance	finance.yahoo	-1
theweek	theweek	-1
supremecourt	supremecourt	-1
media	media.giphy	-1
pinknews	pinknews.co.uk	-1
govtrack	govtrack.us	-1
cia	cia	-1
berniesanders	berniesanders	-1
innocenceproject	innocenceproject	-1
people	people.duke	-1
googleusercontent	lh3.googleusercontent	-1
statisticbrain	statisticbrain	-1
technologyreview	technologyreview	-1
psmag	psmag	-1
citeseerx	citeseerx.ist.psu	-1
nij	nij	-1
worldometers	worldometers.info	-1
techdirt	techdirt	-1
military	military	-1
hrc	hrc	-1
sentencingproject	sentencingproject	-1
donaldjtrump	donaldjtrump	-1
thestar	thestar	-1
insider	insider.foxnews	-1
ons	ons	-1
healthland	healthland.time	-1
politica	politica	-1
bmj	bmj	-1
marxists	marxists	-1
thefederalist	thefederalist	-1
metro	metro.us	-1
logicallyfallacious	logicallyfallacious	-1
healthsystemtracker	healthsystemtracker	-1
static	static.bbc.co.uk	-1
implicit	implicit.harvard	-1
sciencealert	sciencealert	-1
bigthink	bigthink	-1
vi	vi	-1
mentalfloss	mentalfloss	-1
bmcpublichealth	bmcpublichealth.biomedcentral	-1
columbia	tc.columbia	-1
smh	smh	-1
mediamatters	mediamatters	-1
usatoday30	usatoday30.usatoday	-1
dw	dw	-1
rangevoting	rangevoting	-1
uscourts	ca5.uscourts	-1
annals	annals	-1
mirror	mirror.co.uk	-1
simplypsychology	simplypsychology	-1
senate	jec.senate	-1
theblaze	theblaze	-1
constitution	constitution	-1
philpapers	philpapers	-1
dailydot	dailydot	-1
hbswk	hbswk.hbs	-1
express	express.co.uk	-1
uscis	uscis	-1
ucsusa	blog.ucsusa	-1
waitbutwhy	waitbutwhy	-1
thelocal	thelocal.it	-1
eurekalert	eurekalert	-1
justia	law.justia	-1
csmonitor	csmonitor	-1
ytimg	i.ytimg	-1
wolframalpha	wolframalpha	-1
amnesty	amnesty	-1
abs	abs	-1
spotify	open.spotify	-1
nimh	nimh.nih	-1
documentcloud	documentcloud	-1
popsci	popsci	-1
clevelandclinic	health.clevelandclinic	-1
cis	cis	-1
mediabiasfactcheck	mediabiasfactcheck	-1
psychiatry	psychiatry	-1
medicaldaily	images.medicaldaily	-1
gires	gires	-1
rawstory	rawstory	-1
scribd	scribd	-1
avalon	avalon.law.yale	-1
jaacap	jaacap	-1
blacklivesmatter	blacklivesmatter	-1
fao	fao	-1
talkorigins	talkorigins	-1
blog	blog.lib.umn	-1
ussc	ussc	-1
econlib	econlib	-1
facebook	facebook	-1
kotaku	kotaku	-1
laws-lois	laws-lois.justice.gc.ca	-1
iopscience	iopscience.iop	-1
undp	ir.undp	-1
aafp	aafp	-1
denverpost	denverpost	-1
infoplease	infoplease	-1
numbeo	numbeo	-1
u	u	-1
archives	archives	-1
theonion	theonion	-1
economics	economics.mit	-1
timesofisrael	timesofisrael	-1
medrxiv	medrxiv	-1
yang2020	yang2020	-1
duckduckgo	duckduckgo	-1
hawaii	hawaii	-1
theroot	theroot	-1
bustle	bustle	-1
apps	apps.irs	-1
fool	fool	-1
cfr	cfr	-1
mashable	mashable	-1
europepmc	europepmc	-1
isna	isna	-1
peta	peta	-1
amptoons	amptoons	-1
space	nibi.space	-1
vatican	vatican.va	-1
frontiersin	frontiersin	-1
ifstudies	ifstudies	-1
wikiwand	wikiwand	-1
thesocietypages	thesocietypages	-1
photobucket	i216.photobucket	-1
thoughtco	thoughtco	-1
axios	axios	-1
repository	repository.law.umich	-1
transequality	transequality	-1
urban	urban	-1
caselaw	caselaw.findlaw	-1
thereligionofpeace	thereligionofpeace	-1
motherboard	motherboard.vice	-1
prisonpolicy	prisonpolicy	-1
fairvote	fairvote	-1
variety	variety	-1
ideas	ideas.time	-1
federalreserve	federalreserve	-1
psychiatryonline	psychnews.psychiatryonline	-1
wisconsin	docs.legis.wisconsin	-1
townhall	townhall	-1
americanbar	americanbar	-1
genius	genius	-1
thesun	thesun.co.uk	-1
wikileaks	wikileaks	-1
hillaryclinton	hillaryclinton	-1
encrypted-tbn0	encrypted-tbn0.gstatic	-1
chicagobooth	chicagobooth	-1
givewell	givewell	-1
fanfiction\	www\.fanfiction\	-1
eeoc	eeoc	-1
macrotrends	macrotrends	-1
science	science.nasa	-1
fec	fec	-1
gunpolicy	gunpolicy	-1
scienceblogs	scienceblogs	-1
jacobinmag	jacobinmag	-1
radiolab	radiolab	-1
commondreams	commondreams	-1
glaad	glaad	-1
quoracdn	qph.ec.quoracdn	-1
thelizlibrary	thelizlibrary	-1
pcpartpicker	pcpartpicker	-1
okcupid	blog.okcupid	-1
rcpsych	bjp.rcpsych	-1
cbslocal	newyork.cbslocal	-1
texastribune	texastribune	-1
globalresearch	globalresearch.ca	-1
oyez	oyez	-1
psychology	psychology.ucdavis	-1
web	web.mit	-1
democracynow	democracynow	-1
hopkinsmedicine	hopkinsmedicine	-1
jpost	jpost	-1
virginia	provost.virginia	-1
hindawi	hindawi	-1
spiegel	spiegel.de	-1
thecut	thecut	-1
270towin	270towin	-1
gao	gao	-1
mckinsey	mckinsey	-1
ff2ebook	ff2ebook	-1
s3-website-us-east-1	hrc-assets.s3-website-us-east-1.amazonaws	-1
wnycstudios	wnycstudios	-1
upenn	ldi.upenn	-1
talkingpointsmemo	a5.img.talkingpointsmemo	-1
bulbagarden	bulbapedia.bulbagarden	-1
search	ri.search.yahoo	-1
votesmart	votesmart	-1
liveleak	liveleak	-1
cms	cms	-1
wikiquote	en.wikiquote	-1
indexmundi	indexmundi	-1
imf	imf	-1
thefire	thefire	-1
psychologicalscience	psychologicalscience	-1
samharris	samharris	-1
journalistsresource	journalistsresource	-1
nfl	nfl	-1
tgender	tgender	-1
popularmechanics	popularmechanics	-1
pri	pri	-1
gutenberg	gutenberg	-1
chron	chron	-1
public	public.oed	-1
apple	apple	-1
nih	nih	-1
aauw	aauw	-1
iflscience	iflscience	-1
answers	answers.yahoo	-1
joebiden	go.joebiden	-1
pubs	pubs.acs	-1
thecrimson	thecrimson	-1
eff	eff	-1
popehat	popehat	-1
nybooks	nybooks	-1
journalofpsychiatricresearch	journalofpsychiatricresearch	-1
adl	adl	-1
supreme	supreme.justia	-1
statnews	statnews	-1
scmp	scmp	-1
skepticsannotatedbible	skepticsannotatedbible	-1
pewinte	pewinte	-1
nationalgangcenter	nationalgangcenter.ojp	-1
healthaffairs	healthaffairs	-1
nj	nj	-1
wikihow	wikihow	-1
prospect	prospect	-1
sites	sites.duke	-1
gfycat	gfycat	-1
newsroom	newsroom.ucla	-1
northwestern	kellogg.northwestern	-1
sfgate	sfgate	-1
unhcr	unhcr	-1
nocookie	img1.wikia.nocookie	-1
lexico	lexico	-1
examiner	examiner	-1
ctvnews	ctvnews.ca	-1
nsvrc	nsvrc	-1
atf	atf	-1
nutritionfacts	nutritionfacts	-1
esquire	esquire	-1
walmart	walmart	-1
nationalinterest	nationalinterest	-1
uchicago	press.uchicago	-1
scholarl	scholarl	-1
migrationpolicy	migrationpolicy	-1
cbssports	cbssports	-1
support	support.google	-1
quran	quran	-1
socialworkers	socialworkers	-1
research	research.upjohn	-1
earthobservatory	earthobservatory.nasa	-1
ghr	ghr.nlm.nih	-1
khanacademy	khanacademy	-1
bleacherreport	bleacherreport	-1
business	business.time	-1
injuryprevention	injuryprevention.bmj	-1
businessweek	businessweek	-1
hhs	hhs	-1
turner	i2.cdn.turner	-1
encyclopedia	encyclopedia	-1
inc	inc	-1
observer	observer	-1
rasmussenreports	rasmussenreports	-1
mediaite	mediaite	-1
thediplomat	thediplomat	-1
iihs	iihs	-1
mercurynews	mercurynews	-1
oregonlive	gov.oregonlive	-1
pewtrusts	pewtrusts	-1
annualreviews	annualreviews	-1
utexas	zo.utexas	-1
mobile	mobile.abc	-1
loc	loc	-1
naacp	naacp	-1
cell	cell	-1
nationalpriorities	nationalpriorities	-1
gapminder	gapminder	-1
disastercenter	disastercenter	-1
ushmm	ushmm	-1
avoiceformen	avoiceformen	-1
smartasset	smartasset	-1
wlmht	wlmht.nhs.uk	-1
vox-cdn	cdn2.vox-cdn	-1
chronicle	chronicle	-1
boingboing	boingboing	-1
newstatesman	newstatesman	-1
fanfiction	fanfiction	-1
gatherer	gatherer.wizards	-1
io9	io9	-1
econlog	econlog.econlib	-1
canada	canada.ca	-1
voxeu	voxeu	-1
si	si	-1
change	change	-1
vpc	vpc	-1
wnd	wnd	-1
sports	sports.espn.go	-1
cosmopolitan	cosmopolitan	-1
healthcare	healthcare.findlaw	-1
smallbusiness	smallbusiness.chron	-1
staticflickr	farm3.staticflickr	-1
rottentomatoes	rottentomatoes	-1
thoughtcatalog	thoughtcatalog	-1
ahajournals	circ.ahajournals	-1
aap	aap	-1
edweek	edweek	-1
buzzfeednews	buzzfeednews	-1
twimg	pbs.twimg	-1
pewhispanic	pewhispanic	-1
yesmeansyesblog	yesmeansyesblog.wordpress	-1
charitynavigator	charitynavigator	-1
governing	governing	-1
catholic	catholic	-1
sbnation	sbnation	-1
dhs	dhs	-1
aeon	aeon.co	-1
news-medical	news-medical	-1
glassdoor	glassdoor	-1
economicshelp	economicshelp	-1
boston	boston	-1
ranker	ranker	-1
ebay	ebay	-1
listverse	listverse	-1
nhtsa	nhtsa	-1
bop	bop	-1
aspe	aspe.hhs	-1
constitutioncenter	blog.constitutioncenter	-1
escapistmagazine	escapistmagazine	-1
al	al	-1
torontosun	storage.torontosun	-1
ncaa	fs.ncaa	-1
hollywoodreporter	hollywoodreporter	-1
advisorperspectives	advisorperspectives	-1
dallasnews	dallasnews	-1
royalsocietypublishing	royalsocietypublishing	-1
ohchr	ohchr	-1
yale	yale	-1
themarshallproject	themarshallproject	-1
dmv	dmv	-1
discovery	dsc.discovery	-1
bit	bit.ly	-1
quandl	quandl	-1
opinionator	opinionator.blogs.nytimes	-1
jewishvirtuallibrary	jewishvirtuallibrary	-1
scotusblog	scotusblog	-1
ojjdp	ojjdp	-1
puu	puu.sh	-1
verywellmind	verywellmind	-1
tampabay	tampabay	-1
energy	afdc.energy	-1
wikisource	en.wikisource	-1
polygon	polygon	-1
lifehacker	lifehacker	-1
militarytimes	militarytimes	-1
prnewswire	prnewswire	-1
currentaffairs	static.currentaffairs	-1
irishtimes	irishtimes	-1
plosone	plosone	-1
dailymotion	dailymotion	-1
upi	upi	-1
wisc	sts.wisc	-1
medlineplus	medlineplus	-1
utoronto	sds.utoronto.ca	-1
upworthy	upworthy	-1
trends	trends.google	-1
hyperboleandahalf	hyperboleandahalf.blogspot	-1
afsp	afsp	-1
sss	sss	-1
spectator	spectator	-1
grist	grist	-1
bing	bing	-1
legalmatch	lawblog.legalmatch	-1
unodc	unodc	-1
boxofficemojo	boxofficemojo	-1
oecdbetterlifeindex	oecdbetterlifeindex	-1
microsoft	research.microsoft	-1
livestrong	livestrong	-1
collegeboard	sat.collegeboard	-1
lp	lp	-1
harrypotter	harrypotter.wikia	-1
purdue	chem.purdue	-1
defense	defense	-1
treasury	treasury	-1
la	la	-1
elections	elections.nbcnews	-1
dqydj	dqydj	-1
zillow	zillow	-1
worldatlas	worldatlas	-1
sciencebasedmedicine	sciencebasedmedicine	-1
travel	travel.state	-1
mappingpoliceviolence	mappingpoliceviolence	-1
biomedcentral	jehse.biomedcentral	-1
voanews	voanews	-1
newsfeed	newsfeed.time	-1
memidex	memidex	-1
publishing	assets.publishing.service	-1
nami	nami	-1
files	files.eric.ed	-1
deviantart	deviantart	-1
users	users.wfu	-1
menshealth	menshealth	-1
japantimes	japantimes.co.jp	-1
tylervigen	tylervigen	-1
thealternativehypothesis	thealternativehypothesis	-1
translate	translate.google.se	-1
bu	bu	-1
ftp	ftp.iza	-1
fusion	fusion	-1
world	world.time	-1
marketplace	marketplace.firefox	-1
fullfact	fullfact	-1
sec	sec	-1
bankrate	bankrate	-1
rutgers	rci.rutgers	-1
aspca	aspca	-1
legislature	leginfo.legislature.ca	-1
definitions	definitions.uslegal	-1
startribune	m.startribune	-1
inequality	inequality.stanford	-1
theblog	theblog.okcupid	-1
kinja-img	i.kinja-img	-1
samhsa	samhsa	-1
baltimoresun	articles.baltimoresun	-1
freebeacon	freebeacon	-1
jama	jama.jam	-1
faculty	faculty.smu	-1
the-scientist	the-scientist	-1
li	li	-1
engadget	engadget	-1
wol	wol.iza	-1
humanesociety	humanesociety	-1
education	education.jhu	-1
aamc	aamc	-1
gq	gq	-1
study	study	-1
timesofindia	timesofindia.indiatimes	-1
circumcision	circumcision	-1
unicef	unicef	-1
lifesitenews	lifesitenews	-1
hamiltonproject	hamiltonproject	-1
thetrace	thetrace	-1
morningconsult	morningconsult	-1
rochester	urmc.rochester	-1
fcc	fcc	-1
christianpost	christianpost	-1
ropercenter	ropercenter.cornell	-1
policeone	policeone	-1
parl	parl.ca	-1
shrm	shrm	-1
channel4	channel4	-1
iea	iea	-1
billboard	billboard	-1
world-nuclear	world-nuclear	-1
pl	pl	-1
deadspin	deadspin	-1
pgpf	pgpf	-1
gatestoneinstitute	gatestoneinstitute	-1
basketball-reference	basketball-reference	-1
i2	i2.wp	-1
gpo	gpo	-1
digitaltrends	icdn6.digitaltrends	-1
thetruthaboutguns	thetruthaboutguns	-1
priceonomics	blog.priceonomics	-1
realclearscience	realclearscience	-1
kqed	kqed	-1
ign	ign	-1
washingtonsblog	washingtonsblog	-1
theanarchistlibrary	theanarchistlibrary	-1
marvel	marvel.wikia	-1
prb	prb	-1
sanders	sanders.senate	-1
english	english.pravda.ru	-1
quillette	quillette	-1
itspronouncedmetrosexual	itspronouncedmetrosexual	-1
intelligence	intelligence	-1
inquisitr	inquisitr	-1
ruqqus	ruqqus	-1
drugpolicy	drugpolicy	-1
extremetech	extremetech	-1
miamiherald	miamiherald	-1
rsf	rsf	-1
dsm5	dsm5	-1
carbonbrief	carbonbrief	-1
cepr	cepr	-1
guardian	guardian.co.uk	-1
smartgunlaws	smartgunlaws	-1
squarespace	static1.squarespace	-1
thetimes	thetimes.co.uk	-1
democrats	democrats.senate	-1
nlm	nlm.nih	-1
americanthinker	americanthinker	-1
immigrationpolicy	immigrationpolicy	-1
imgflip	i.imgflip	-1
gotquestions	gotquestions	-1
amp	amp.cnn	-1
wbur	wbur	-1
azcentral	archive.azcentral	-1
oli	oli.cmu	-1
presidency	presidency.ucsb	-1
sciencenews	sciencenews	-1
gwern	gwern	-1
beckershospitalreview	beckershospitalreview	-1
visualcapitalist	visualcapitalist	-1
monsanto	monsanto	-1
vaccines	vaccines.procon	-1
economix	economix.blogs.nytimes	-1
about	about.usps	-1
c-span	c-span	-1
transadvocate	transadvocate	-1
spinoff	spinoff.nasa	-1
stack	i.stack.imgur	-1
timeshighe	timeshighe	-1
spectrum	spectrum.ieee	-1
salary	salary	-1
i0	i0.wp	-1
ojp	ojp	-1
ama-assn	ama-assn	-1
cc	cc	-1
macleans	macleans.ca	-1
myanimelist	myanimelist	-1
econtalk	econtalk	-1
self	self	-1
nyclu	nyclu	-1
scholarworks	scholarworks.montana	-1
electology	electology.github.io	-1
dailysignal	dailysignal	-1
kickstarter	kickstarter	-1
toronto	toronto.ctvnews.ca	-1
arrow-journal	arrow-journal	-1
steampowered	store.steampowered	-1
theoatmeal	theoatmeal	-1
huduser	huduser	-1
streamable	streamable	-1
consumerreports	consumerreports	-1
feministing	feministing	-1
informationisbeautiful	informationisbeautiful	-1
newsmax	newsmax	-1
thefirearmblog	thefirearmblog	-1
thestranger	thestranger	-1
heavy	heavy	-1
isidewith	isidewith	-1
ajc	ajc	-1
itep	itep	-1
psychiatrictimes	psychiatrictimes	-1
ohrc	ohrc.on.ca	-1
start	start.umd	-1
criminal	criminal.findlaw	-1
prri	prri	-1
livingwage	livingwage.mit	-1
teenvogue	teenvogue	-1
library	library.g	-1
obamawhitehouse	obamawhitehouse.archives	-1
finaid	finaid	-1
nyc	nyc	-1
treehugger	treehugger	-1
foreignaffairs	foreignaffairs	-1
oregonstate	oregonstate	-1
truth-out	truth-out	-1
dogsbite	blog.dogsbite	-1
poetryfoundation	poetryfoundation	-1
deseretnews	deseretnews	-1
prosperity	prosperity	-1
dietitians	dietitians.ca	-1
illinois	news.illinois	-1
assets2	assets2.hrc	-1
ncase	ncase.me	-1
niddk	niddk.nih	-1
csulb	csulb	-1
tcf	tcf	-1
childwelfare	childwelfare	-1
journalism	journalism	-1
yourveganfallacyis	yourveganfallacyis	-1
civilrights	civilrights	-1
consumerist	consumerist	-1
babycenter	babycenter	-1
clinicaltrials	clinicaltrials	-1
wallethub	wallethub	-1
city-journal	city-journal	-1
caranddriver	caranddriver	-1
freethoughtblogs	freethoughtblogs	-1
minneapolisfed	minneapolisfed	-1
vocativ	vocativ	-1
lesac	lesac	-1
vulture	vulture	-1
newegg	newegg	-1
usafacts	usafacts	-1
gop	gop	-1
courses	courses.csail.mit	-1
gyazo	i.gyazo	-1
sli	i.sli.mg	-1
bjsm	bjsm.bmj	-1
suntimes	chicago.suntimes	-1
jsonline	archive.jsonline	-1
cleveland	cleveland	-1
zerohedge	zerohedge	-1
oxfordlearnersdictionaries	oxfordlearnersdictionaries	-1
evolution	evolution.berkeley	-1
deathpenalty	deathpenalty	-1
wikiislam	wikiislam	-1
johnstonsarchive	johnstonsarchive	-1
theamericanconservative	theamericanconservative	-1
transparency	transparency	-1
greenpeace	greenpeace	-1
corestandards	corestandards	-1
alamy	n7.alamy	-1
philly	philly	-1
complex	complex	-1
bible	viz.bible	-1
amnestyusa	amnestyusa	-1
dilbert	dilbert	-1
civilwar	civilwar	-1
itunes	itunes.apple	-1
wizards	wizards	-1
marripedia	marripedia	-1
krugman	krugman.blogs.nytimes	-1
collinsdictionary	collinsdictionary	-1
cidrap	cidrap.umn	-1
nerdwallet	nerdwallet	-1
jhsph	jhsph	-1
vegansociety	vegansociety	-1
consad	consad	-1
what-if	what-if.xkcd	-1
projects	projects.thestar	-1
frontpagemag	frontpagemag	-1
www3	www3.nd	-1
z	z	-1
cjr	cjr	-1
wpath	wpath	-1
jme	jme.bmj	-1
ftc	ftc	-1
investors	investors	-1
refinery29	refinery29	-1
nizkor	nizkor	-1
them	them.us	-1
opendemocracy	opendemocracy	-1
organdonor	organdonor	-1
nation	nation.co.ke	-1
aarp	aarp	-1
pinterest	pinterest.se	-1
legislation	legislation	-1
sba	sba	-1
gamasutra	gamasutra	-1
object	object.cato	-1
biblestudytools	biblestudytools	-1
gamespot	gamespot	-1
nationaljournal	nationaljournal	-1
medicine	medicine.ucalgary.ca	-1
dtic	dtic.mil	-1
unesco	unesco	-1
physiology	physiology	-1
liebertpub	online.liebertpub	-1
unz	unz	-1
tinypic	tinypic	-1
boredpanda	boredpanda	-1
infowars	infowars	-1
iastate	ent.iastate	-1
healthychildren	healthychildren	-1
americanpregnancy	americanpregnancy	-1
pages	pages.ucsd	-1
existentia	existentia	-1
datacenter	datacenter.kidscount	-1
parliament	parliament.uk	-1
eric	eric.ed	-1
city-data	city-data	-1
bloombergview	bloombergview	-1
mlive	mlive	-1
adnausi	adnausi.ca	-1
acsh	acsh	-1
billmoyers	billmoyers	-1
ncpa	ncpa	-1
amren	amren	-1
cdn	cdn.yo	-1
podcasts	podcasts.apple	-1
uky	uky	-1
politicususa	politicususa	-1
americanimmigrationcouncil	americanimmigrationcouncil	-1
youarenotsosmart	youarenotsosmart	-1
yimg	s.yimg	-1
abc7news	abc7news	-1
www-m	www-m.cnn	-1
aynrandlexicon	aynrandlexicon	-1
straightdope	straightdope	-1
nraila	nraila	-1
teni	teni.ie	-1
scc-csc	scc-csc.lexum	-1
hrsa	hrsa	-1
panda	wwf.panda	-1
coronavirus	coronavirus.jhu	-1
greatergood	greatergood.berkeley	-1
entrepreneur	entrepreneur	-1
gatesfoundation	gatesfoundation	-1
gunviolencearchive	gunviolencearchive	-1
forward	blogs.forward	-1
nextbigfuture	nextbigfuture	-1
stats	stats.oecd	-1
sacbee	sacbee	-1
childtrends	childtrends	-1
metacritic	metacritic	-1
brown	brown	-1
intelligencesqua	intelligencesqua	-1
legalzoom	legalzoom	-1
blogs-images	blogs-images.forbes	-1
wikia	lotr.wikia	-1
nutritiondata	nutritiondata.self	-1
freep	freep	-1
tufts	chem.tufts	-1
nps	nps	-1
feelthebern	feelthebern	-1
france24	france24	-1
animalvisuals	animalvisuals	-1
quickfacts	quickfacts.census	-1
poverty	poverty	-1
indeed	indeed	-1
autismresearchcentre	docs.autismresearchcentre	-1
weeklystandard	weeklystandard	-1
thefiscaltimes	thefiscaltimes	-1
ppic	ppic	-1
abajournal	abajournal	-1
washingtonmonthly	washingtonmonthly	-1
freedomhouse	freedomhouse	-1
ac360	ac360.blogs.cnn	-1
feedingamerica	feedingamerica	-1
redstate	redstate	-1
deadline	deadline	-1
cleantechnica	cleantechnica	-1
firstlook	firstlook	-1
redditblog	redditblog	-1
ets	ets	-1
stltoday	stltoday	-1
davidcard	davidcard.berkeley	-1
nist	nist	-1
linkedin	linkedin	-1
thefreethoughtproject	thefreethoughtproject	-1
law	law.gmu	-1
mercatus	mercatus	-1
econstor	econstor.eu	-1
avma	avma	-1
cowspiracy	cowspiracy	-1
counterpunch	counterpunch	-1
osha	osha	-1
memory-alpha	en.memory-alpha	-1
elitedaily	elitedaily	-1
oecd-ilibrary	oecd-ilibrary	-1
army	army.mil	-1
medicin	medicin	-1
civitas	civitas	-1
stripes	stripes	-1
penny-arcade	penny-arcade	-1
thejournal	thejournal.ie	-1
globalrichlist	globalrichlist	-1
thewire	thewire	-1
hotair	hotair	-1
acog	acog	-1
catalyst	catalyst	-1
vocabulary	vocabulary	-1
religionnews	tobingrant.religionnews	-1
represent	represent.us	-1
ucdavis	vetmed.ucdavis	-1
randalolson	randalolson	-1
i1	i1.wp	-1
www-personal	www-personal.umich	-1
marginalrevolution	marginalrevolution	-1
endocrine	press.endocrine	-1
ivn	ivn.us	-1
splinternews	splinternews	-1
justfacts	justfacts	-1
dreamstime	thumbs.dreamstime	-1
ilo	ilo	-1
dancarlin	dancarlin	-1
ae911truth	ae911truth	-1
religioustolerance	religioustolerance	-1
medical-dictionary	medical-dictionary.thefreedictionary	-1
nrdc	nrdc	-1
philanthropy	philanthropy.iupui	-1
pcworld	pcworld	-1
mitpressjournals	mitpressjournals	-1
psych	www2.psych.ubc.ca	-1
hpmor	hpmor	-1
avclub	news.avclub	-1
acf	acf.hhs	-1
therichest	therichest	-1
electproject	electproject	-1
flickr	flickr	-1
va	va	-1
medpagetoday	medpagetoday	-1
aaafoundation	aaafoundation	-1
torrentfreak	torrentfreak	-1
bizjournals	bizjournals	-1
siteresources	siteresources.worldbank	-1
ada	ada	-1
philanthropyroundtable	philanthropyroundtable	-1
criminaldefenselawyer	criminaldefenselawyer	-1
americanaddictioncenters	americanaddictioncenters	-1
drugwarfacts	drugwarfacts	-1
alexa	alexa	-1
addons	addons.opera	-1
adguard	adguard	-1
graphics8	graphics8.nytimes	-1
verywellfamily	verywellfamily	-1
fairus	fairus	-1
seriouseats	slice.seriouseats	-1
lazard	lazard	-1
joincampaignzero	joincampaignzero	-1
ncadv	ncadv	-1
worldhunger	worldhunger	-1
dropbox	dropbox	-1
eater	eater	-1
livejournal	bradhicks.livejournal	-1
stackoverflow	stackoverflow	-1
bartleby	bartleby	-1
ustr	ustr	-1
courier-journal	courier-journal	-1
predictit	predictit	-1
budget	budget	-1
cba	cba	-1
sbs	sbs	-1
climat	climat	-1
vanderbilt	vanderbilt	-1
mnn	mnn	-1
kjpl	kjpl	-1
rense	rense	-1
diffen	diffen	-1
lds	lds	-1
usccb	usccb	-1
mcgill	mcgill.ca	-1
givingwhatwecan	givingwhatwecan	-1
yo	yo	-1
now	now	-1
emilkirkegaard	emilkirkegaard.dk	-1
studentaid	studentaid	-1
lawfareblog	lawfareblog	-1
gimletmedia	gimletmedia	-1
ibb	ibb.co	-1
iucnredlist	iucnredlist	-1
oed	oed	-1
environment	environment.yale	-1
math	math.hmc	-1
worldhappiness	worldhappiness.report	-1
utilitarian	utilitarian	-1
bgr	bgr	-1
newyorkfed	newyorkfed	-1
globalissues	globalissues	-1
crfb	crfb	-1
maps	maps.app.goo.gl	-1
thehindu	thehindu	-1
equal	equal.vote	-1
globalchange	science2017.globalchange	-1
monticello	monticello	-1
schneier	schneier	-1
coursera	coursera	-1
usaid	usaid	-1
allthatsinteresting	allthatsinteresting	-1
theage	theage	-1
carm	carm	-1
screenrant	screenrant	-1
naturalnews	naturalnews	-1
covid	covid.cdc	-1
prod-cdn-static	prod-cdn-static.gop	-1
poll	poll.qu	-1
nobelprize	nobelprize	-1
law2	law2.umkc	-1
press-pubs	press-pubs.uchicago	-1
sparknotes	sparknotes	-1
economictimes	economictimes.indiatimes	-1
ironchariots	wiki.ironchariots	-1
xojane	xojane	-1
pro-football-reference	pro-football-reference	-1
abort73	abort73	-1
erowid	erowid	-1
khn	khn	-1
fhwa	fhwa.dot	-1
historyofvaccines	historyofvaccines	-1
answersingenesis	answersingenesis	-1
ceoworld	ceoworld.biz	-1
allrecipes	allrecipes	-1
mdpi	mdpi	-1
researchnews	researchnews.osu	-1
postcog	postcog.ucd.ie	-1
foxbusiness	foxbusiness	-1
boundless	boundless	-1
e360	e360.yale	-1
diabetesjournals	clinical.diabetesjournals	-1
daa	daa.asn.au	-1
choosemyplate	choosemyplate	-1
texas	dps.texas	-1
frbsf	frbsf	-1
parents	parents	-1
conservapedia	conservapedia	-1
fcmconference	fcmconference	-1
stuff	i.stuff.co.nz	-1
michigan	michigan	-1
msmagazine	msmagazine	-1
aph	aph	-1
pics	pics.me.me	-1
lgbtqnation	bilerico.lgbtqnation	-1
futurism	futurism	-1
nickbostrom	nickbostrom	-1
oxfam	oxfam	-1
jaapl	jaapl	-1
usa	usa	-1
motorists	motorists	-1
orlandosentinel	orlandosentinel	-1
nationalparent	nationalparent	-1
personal	personal.psu	-1
azlyrics	azlyrics	-1
ichef	ichef.bbci.co.uk	-1
guns	guns	-1
pcgamer	pcgamer	-1
gunfacts	gunfacts.info	-1
pastemagazine	pastemagazine	-1
pricetheory	pricetheory.uchicago	-1
eprints	eprints.lse.ac.uk	-1
cihi	cihi.ca	-1
lawcenter	lawcenter.giffords	-1
parenting	parenting	-1
hathitrust	catalog.hathitrust	-1
ucsb	soc.ucsb	-1
redditmedia	b.thumbs.redditmedia	-1
verywellhealth	verywellhealth	-1
demos	demos	-1
harpers	harpers	-1
piketty	piketty.pse.ens.fr	-1
netflix	netflix	-1
cbp	cbp	-1
venturebeat	venturebeat	-1
www-nrd	www-nrd.nhtsa.dot	-1
physics	physics.ucsd	-1
nsf	nsf	-1
thesaurus	thesaurus	-1
hbs	hbs	-1
raikoth	raikoth	-1
philosophy	philosophy.lander	-1
genocidewatch	genocidewatch	-1
acpeds	acpeds	-1
water	water.usgs	-1
deanradin	deanradin	-1
hg	hg	-1
harvardmagazine	harvardmagazine	-1
goodmenproject	goodmenproject	-1
bigstory	bigstory.ap	-1
sfchronicle	sfchronicle	-1
educationnext	educationnext	-1
everydayhealth	everydayhealth	-1
onecle	law.onecle	-1
weather	weather	-1
mcclatchydc	mcclatchydc	-1
standard	standard	-1
multpl	multpl	-1
amjmed	amjmed	-1
askmen	askmen	-1
iwpr	iwpr	-1
postimg	s23.postimg	-1
accessdata	accessdata.fda	-1
bostonreview	bostonreview	-1
heartandstroke	heartandstroke	-1
niehs	ehp.niehs.nih	-1
apsa	apsa	-1
wnyc	wnyc	-1
outsports	outsports	-1
acpjournals	acpjournals	-1
glamour	glamour	-1
thecanadianencyclopedia	thecanadianencyclopedia.ca	-1
skeptoid	skeptoid	-1
umass	geo.umass	-1
africa	africa.upenn	-1
wattsupwiththat	wattsupwiththat	-1
sourcewatch	sourcewatch	-1
escholarship	escholarship	-1
heraldtribune	projects.heraldtribune	-1
open	open.lib.umn	-1
northeastern	news.northeastern	-1
umn	d.umn	-1
learn	learn.fi	-1
justsecurity	justsecurity	-1
ibiblio	ibiblio	-1
ssl-images-amazon	images-na.ssl-images-amazon	-1
nationalhomeless	nationalhomeless	-1
onegreenpl	onegreenpl	-1
ontario	ontario.ca	-1
vancouversun	blogs.vancouversun	-1
statelaws	statelaws.findlaw	-1
worldpublicopinion	worldpublicopinion	-1
lewrockwell	archive.lewrockwell	-1
ew	ew	-1
econ	econ.la.psu	-1
stitcher	stitcher	-1
sapac	sapac.umich	-1
wikibooks	en.wikibooks	-1
newadvent	newadvent	-1
previews	previews.123rf	-1
dartmouth	dartmouth	-1
detroitnews	amp.detroitnews	-1
slidesharecdn	image.slidesharecdn	-1
desmogblog	desmogblog	-1
policymic	policymic	-1
jalopnik	jalopnik	-1
copyright	copyright	-1
examine	examine	-1
publications	publications.parliament.uk	-1
crashstats	crashstats.nhtsa.dot	-1
everytownresearch	everytownresearch	-1
chabad	chabad	-1
assets	assets.csom.umn	-1
openborders	openborders.info	-1
99percentinvisible	99percentinvisible	-1
islamqa	islamqa.info	-1
rdcu	rdcu.be	-1
thegrayzone	thegrayzone	-1
tobaccocontrol	tobaccocontrol.bmj	-1
nautil	nautil.us	-1
heinonline	heinonline	-1
feministcurrent	feministcurrent	-1
towardsdatascience	towardsdatascience	-1
kingjamesbibleonline	kingjamesbibleonline	-1
freerepublic	freerepublic	-1
house	house	-1
culturalcognition	culturalcognition	-1
core	core.ac.uk	-1
fair	fair	-1
theaustralian	theaustralian	-1
thetaskforce	thetaskforce	-1
tippingresearch	tippingresearch	-1
statesman	statesman	-1
tabletmag	tabletmag	-1
healio	healio	-1
nationalpopularvote	nationalpopularvote	-1
nyti	nyti.ms	-1
nhmrc	nhmrc	-1
helpguide	helpguide	-1
indiana	ibrc.indiana	-1
simulation-argument	simulation-argument	-1
nola	nola	-1
westeros	awoiaf.westeros	-1
topuniversities	topuniversities	-1
psychohistory	psychohistory	-1
80000hours	80000hours	-1
lumenlearning	courses.lumenlearning	-1
businesswire	businesswire	-1
floridapolitics	floridapolitics	-1
eurogamer	eurogamer	-1
shrinkthatfootprint	shrinkthatfootprint	-1
mit	mit	-1
static01	static01.nyt	-1
medicalxpress	medicalxpress	-1
ferris	ferris	-1
streetsblog	usa.streetsblog	-1
preview	preview.redd.it	-1
rollcall	rollcall	-1
arcgis	arcgis	-1
pubpages	pubpages.unh	-1
valuepenguin	valuepenguin	-1
americannutritionassociation	americannutritionassociation	-1
biography	biography	-1
science20	science20	-1
dsausa	dsausa	-1
publicintegrity	publicintegrity	-1
indiewire	blogs.indiewire	-1
bloodyelbow	bloodyelbow	-1
broadly	broadly.vice	-1
thewrap	thewrap	-1
redcrossblood	redcrossblood	-1
timwise	timwise	-1
ushistory	ushistory	-1
belie	belie	-1
brainyquote	brainyquote	-1
thedailyshow	thedailyshow.cc	-1
epionline	epionline	-1
libertarianism	libertarianism	-1
pcrm	pcrm	-1
cancerresearchuk	cancerresearchuk	-1
admissions	admissions.berkeley	-1
extension	extension.purdue	-1
paulgraham	paulgraham	-1
richmond	richmond	-1
kinseyinstitute	kinseyinstitute	-1
daviddfriedman	daviddfriedman	-1
journalofethics	journalofethics.ama-assn	-1
charitywatch	charitywatch	-1
ocw	ocw.mit	-1
alarabiya	english.alarabiya	-1
cic	cic.gc.ca	-1
co	g.co	-1
allsides	allsides	-1
theincidentaleconomist	theincidentaleconomist	-1
thecollegefix	thecollegefix	-1
udel	udel	-1
mentalhealth	mentalhealth	-1
gettyimages	media.gettyimages	-1
usdoj	cops.usdoj	-1
metacpan	metacpan	-1
embryology	embryology.ch	-1
external-content	external-content.duckduckgo	-1
mattbruenig	mattbruenig	-1
ninehundred	ninehundred	-1
newsone	newsone	-1
inflationdata	inflationdata	-1
manhattan-institute	manhattan-institute	-1
swissinfo	swissinfo.ch	-1
oddee	oddee	-1
autismspeaks	autismspeaks	-1
giphy	giphy	-1
publicpolicypolling	publicpolicypolling	-1
rankingsandreviews	grad-schools.usnews.rankingsandreviews	-1
nbcsandiego	nbcsandiego	-1
quoteinvestigator	quoteinvestigator	-1
bra	bra.se	-1
gmoanswers	gmoanswers	-1
ingentaconnect	ingentaconnect	-1
unfccc	unfccc.int	-1
histor	histor	-1
cen	cen.acs	-1
usmagazine	usmagazine	-1
pnhp	pnhp	-1
gnu	gnu	-1
cinemablend	cinemablend	-1
genome	genome	-1
wwwnc	wwwnc.cdc	-1
imgs	imgs.xkcd	-1
americamagazine	americamagazine	-1
ruger	ruger	-1
ucsf	ucsf	-1
buckeyefirearms	buckeyefirearms	-1
debate	debate	-1
mintpressnews	mintpressnews	-1
yudkowsky	yudkowsky	-1
iq-research	iq-research.info	-1
volokh	volokh	-1
sciencenordic	sciencenordic	-1
ipsos	ipsos	-1
changeaview	changeaview	-1
cra-arc	cra-arc.gc.ca	-1
atlantablackstar	atlantablackstar	-1
hoover	hoover	-1
mentalhealthdaily	mentalhealthdaily	-1
washingtoncitypaper	washingtoncitypaper	-1
ycharts	ycharts	-1
feminist	feminist	-1
ijreview	ijreview	-1
mprnews	blogs.mprnews	-1
cdn-images-1	cdn-images-1.medium	-1
dosomething	dosomething	-1
worldwatch	worldwatch	-1
melbourneinstitute	melbourneinstitute	-1
responsibility	responsibility	-1
minnpost	minnpost	-1
statutes	statutes.legis.state.tx.us	-1
usinflationcalculator	usinflationcalculator	-1
sun-sentinel	sun-sentinel	-1
theregister	theregister.co.uk	-1
courtlistener	courtlistener	-1
latimesblogs	latimesblogs.latimes	-1
advocatesforyouth	advocatesforyouth	-1
openargs	openargs	-1
basici	basici	-1
unc	unc	-1
muse	muse.jhu	-1
historynew	historynew	-1
tmz	tmz	-1
indystar	indystar	-1
equality-of-opportunity	equality-of-opportunity	-1
openbible	openbible.info	-1
documents	documents.worldbank	-1
daily	daily.jstor	-1
stillmed	stillmed.olympic	-1
reasonablefaith	reasonablefaith	-1
armytimes	armytimes	-1
abc7	abc7	-1
apadivisions	apadivisions	-1
csgjusticecenter	csgjusticecenter	-1
nationalarchives	webarchive.nationalarchives	-1
gotopless	gotopless	-1
adweek	adweek	-1
cgpgrey	cgpgrey	-1
thenewamerican	thenewamerican	-1
womenshealth	womenshealth	-1
theamericanmuslim	theamericanmuslim	-1
images-amazon	ecx.images-amazon	-1
globalcitizen	globalcitizen	-1
logicalfallacies	logicalfallacies	-1
juancole	juancole	-1
the-numbers	the-numbers	-1
cbs	cbs	-1
gothamist	gothamist	-1
nbcnewyork	nbcnewyork	-1
ine	ine.uaf	-1
retractionwatch	retractionwatch	-1
healthyplace	healthyplace	-1
psypost	psypost	-1
pjmedia	pjmedia	-1
rferl	rferl	-1
timeinc	img2-3.timeinc	-1
lung	lung	-1
cmaj	cmaj.ca	-1
d3n8a8pro7vhmx	d3n8a8pro7vhmx.cloudfront	-1
frac	frac	-1
dailystormer	dailystormer	-1
universityofcalifornia	universityofcalifornia	-1
euronews	euronews	-1
i	i.	-1
nsc	nsc	-1
wehuntedthemammoth	wehuntedthemammoth	-1
fws	fws	-1
imperial	imperial.ac.uk	-1
reports	reports.oah.state.nc.us	-1
pca	pca.st	-1
foxsports	msn.foxsports	-1
edmunds	edmunds	-1
aifs	aifs	-1
piie	piie	-1
atheism	atheism.about	-1
uptodate	uptodate	-1
codes	codes.ohio	-1
bet	bet	-1
247wallst	247wallst	-1
landonswan	blog.landonswan	-1
zesty	zesty.ca	-1
rogerebert	rogerebert	-1
arc-anglerfish-washpost-prod-washpost	arc-anglerfish-washpost-prod-washpost.s3.amazonaws	-1
additudemag	additudemag	-1
hub	hub.jhu	-1
info	web.mta.info	-1
fraserinstitute	fraserinstitute	-1
fifa	fifa	-1
curbed	curbed	-1
teamliquid	wiki.teamliquid	-1
portal	portal.hud	-1
inverse	inverse	-1
heart	heart	-1
NationalPopularVote	NationalPopularVote	-1
redditinc	redditinc	-1
encrypted	encrypted.google	-1
levine	levine.ss	-1
skyscraperpage	skyscraperpage	-1
food	food	-1
geek	geek	-1
businessnewsdaily	businessnewsdaily	-1
pokemondb	pokemondb	-1
jbhe	jbhe	-1
th	th	-1
redlettermedia	redlettermedia	-1
cheatsheet	cheatsheet	-1
sprc	sprc	-1
computerworld	computerworld	-1
openculture	openculture	-1
insideclimatenews	insideclimatenews	-1
peterleeson	peterleeson	-1
realclimate	realclimate	-1
canlii	canlii	-1
givedirectly	givedirectly	-1
digitaljournal	digitaljournal	-1
advisory	advisory	-1
cochrane	cochrane	-1
olympic	olympic	-1
damninteresting	damninteresting	-1
colorlines	colorlines	-1
smallarmssurvey	smallarmssurvey	-1
cgdev	cgdev	-1
ethnicity-facts-figures	ethnicity-facts-figures.service	-1
lawandcrime	lawandcrime	-1
msu	msu	-1
thecolbertreport	thecolbertreport.cc	-1
tripadvisor	media-cdn.tripadvisor	-1
archlinux	bbs.archlinux	-1
nasdaq	nasdaq	-1
doctorsopposingcircumcision	doctorsopposingcircumcision	-1
petmd	petmd	-1
oxfordmartin	oxfordmartin.ox.ac.uk	-1
adage	adage	-1
genderanalysis	genderanalysis	-1
csis	csis	-1
corporate	corporate.target	-1
presidential-candidates	presidential-candidates.insid	-1
sltrib	sltrib	-1
endhomelessness	endhomelessness	-1
drugs	drugs	-1
tomwoods	tomwoods	-1
nytlive	nytlive.nytimes	-1
yelp	yelp	-1
shopify	cdn.shopify	-1
jordanbpeterson	jordanbpeterson	-1
ilga	ilga	-1
organicconsumers	organicconsumers	-1
seattlepi	blog.seattlepi	-1
edge	edge	-1
languagelog	languagelog.ldc.upenn	-1
thebureauinvestigates	thebureauinvestigates	-1
authoritynutrition	authoritynutrition	-1
rooseveltinstitute	rooseveltinstitute	-1
inte	inte	-1
amsa	amsa	-1
al-islam	al-islam	-1
electora	electora	-1
finallyfeminism101	finallyfeminism101.wordpress	-1
middleeasteye	middleeasteye	-1
legis	legis.state.pa.us	-1
pcpsr	pcpsr	-1
dni	dni	-1
linkinghub	linkinghub.elsevier	-1
dana	dana	-1
atheists	atheists	-1
francoistremblay	francoistremblay.wordpress	-1
typepad	a4.typepad	-1
mitadmissions	mitadmissions	-1
projectvote	projectvote	-1
unwomen	unwomen	-1
yaleclimateconnections	yaleclimateconnections	-1
maa	maa	-1
lifenews	lifenews	-1
patch	patch	-1
ndaa	ndaa	-1
insurancejournal	insurancejournal	-1
monster	monster	-1
sportsbusinessdaily	sportsbusinessdaily	-1
post-gazette	post-gazette	-1
syracuse	syracuse	-1
myfitnesspal	blog.myfitnesspal	-1
turbotax	turbotax.intuit	-1
suicidepreventionlifeline	suicidepreventionlifeline	-1
historians	historians	-1
newamerica	static.newamerica	-1
nhlbi	nhlbi.nih	-1
sandiegouniontribune	sandiegouniontribune	-1
jta	jta	-1
thenextweb	thenextweb	-1
womenshealthmag	womenshealthmag	-1
mtv	mtv	-1
home	home.nra	-1
slideshare	slideshare	-1
knowledge	knowledge.wharton.upenn	-1
jahonline	jahonline	-1
eh	eh	-1
uab	uab	-1
fdic	fdic	-1
kirwaninstitute	kirwaninstitute.osu	-1
guncite	guncite	-1
nielsen	nielsen	-1
econfaculty	econfaculty.gmu	-1
ncse	ncse	-1
lostallhope	lostallhope	-1
redditsearch	redditsearch.io	-1
karger	karger	-1
wri	wri	-1
parentingscience	parentingscience	-1
proquest	search.proquest	-1
heterodoxacademy	heterodoxacademy	-1
nwlc	nwlc	-1
lao	lao.ca	-1
infidels	infidels	-1
economicsdetective	economicsdetective	-1
s-nbcnews	media4.s-nbcnews	-1
courts	courts.ca	-1
bitcoin	en.bitcoin.it	-1
thegatewaypundit	thegatewaypundit	-1
geekfeminism	geekfeminism.wikia	-1
slashdot	slashdot	-1
gesetze-im-inte	gesetze-im-inte	-1
haydenpl	haydenpl	-1
felonvoting	felonvoting.procon	-1
consc	consc	-1
nichd	nichd.nih	-1
emedicine	emedicine.medscape	-1
wfp	wfp	-1
focusonthefamily	dailycitizen.focusonthefamily	-1
areavibes	areavibes	-1
tesla	tesla	-1
christianitytoday	christianitytoday	-1
nrc	nrc	-1
cew	cew.g	-1
villagevoice	blogs.villagevoice	-1
nzherald	nzherald.co.nz	-1
rapgenius	rapgenius	-1
storify	storify	-1
googleapis	think.storage.googleapis	-1
straitstimes	straitstimes	-1
elementascience	elementascience	-1
oxfordreference	oxfordreference	-1
wjla	wjla	-1
buzzfed	ak-hdl.buzzfed	-1
ornl	web.ornl	-1
themoscowtimes	themoscowtimes	-1
saveservices	saveservices	-1
theundefeated	theundefeated	-1
econjwatch	econjwatch	-1
hindustantimes	hindustantimes	-1
greentechmedia	greentechmedia	-1
click	dont.click.hover.for.note	-1
eji	eji	-1
sanfrancisco	sanfrancisco.cbslocal	-1
familyfacts	familyfacts	-1
takepart	takepart	-1
crf-usa	crf-usa	-1
lifehack	lifehack	-1
datagraver	datagraver	-1
equitablemath	equitablemath	-1
ammoland	ammoland	-1
legacy	legacy.tyt	-1
thelawdictionary	thelawdictionary	-1
shouselaw	shouselaw	-1
yourdictionary	yourdictionary	-1
uofmhealth	labblog.uofmhealth	-1
livemint	livemint	-1
biblia	biblia	-1
collective-evolution	collective-evolution	-1
drinkingage	drinkingage.procon	-1
ratical	ratical	-1
artofmanliness	artofmanliness	-1
pcmag	pcmag	-1
freethoughtpedia	freethoughtpedia	-1
dailycal	dailycal	-1
climatechange2013	climatechange2013	-1
dailytelegraph	dailytelegraph	-1
teachingamericanhistory	teachingamericanhistory	-1
alicdn	g03.a.alicdn	-1
publicbroadcasting	mediad.publicbroadcasting	-1
removeddit	removeddit	-1
govinfo	govinfo	-1
oregon	oregon	-1
newsbusters	newsbusters	-1
mtsu	mtsu	-1
al-monitor	al-monitor	-1
quickmeme	quickmeme	-1
kansascity	kansascity	-1
ucsfhealth	ucsfhealth	-1
bc	bc	-1
ggpht	lh5.ggpht	-1
todayifoundout	todayifoundout	-1
poynter	poynter	-1
zendesk	reddit.zendesk	-1
skepdic	skepdic	-1
audible	audible	-1
biorxiv	biorxiv	-1
gatech	cos.gatech	-1
nccp	nccp	-1
nea	nea	-1
abovethelaw	abovethelaw	-1
ij	ij	-1
upc-online	upc-online	-1
abc13	abc13	-1
aol	aol	-1
timeout	media.timeout	-1
diversityinc	diversityinc	-1
practicalethics	blog.practicalethics.ox.ac.uk	-1
wgntv	wgntv	-1
suicide	suicide	-1
iranprimer	iranprimer.usip	-1
raceandpolicing	raceandpolicing.issuelab	-1
thesimpledollar	thesimpledollar	-1
collegereadiness	collegereadiness.collegeboard	-1
zpub	zpub	-1
usdebtclock	usdebtclock	-1
revealnews	revealnews	-1
justicepolicy	justicepolicy	-1
naturalfinance	naturalfinance	-1
recode	recode	-1
transition	transition.fcc	-1
celebrit	celebrit	-1
prostitutionresearch	prostitutionresearch	-1
nbcwashington	nbcwashington	-1
instituteforenergyresearch	instituteforenergyresearch	-1
stateofobesity	stateofobesity	-1
pitt	pitt	-1
abc7chicago	abc7chicago	-1
founders	founders.archives	-1
memory	memory.loc	-1
catholicnewsagency	catholicnewsagency	-1
tolerance	tolerance	-1
thelastpsychiatrist	thelastpsychiatrist	-1
mondoweiss	mondoweiss	-1
thedodo	thedodo	-1
thedailybanter	thedailybanter	-1
sos	sos.wa	-1
desmoinesregister	desmoinesregister	-1
list	list.ly	-1
centerforsecuritypolicy	centerforsecuritypolicy	-1
jihadwatch	jihadwatch	-1
elderscrolls	elderscrolls.wikia	-1
emerald	emerald	-1
engineering	engineering.stanford	-1
archpsyc	archpsyc.jam	-1
euractiv	euractiv	-1
chomsky	chomsky.info	-1
powerlisting	powerlisting.wikia	-1
kidney	kidney	-1
pollingreport	pollingreport	-1
perl6	docs.perl6	-1
kidshealth	kidshealth	-1
courthousenews	courthousenews	-1
peoplespolicyproject	peoplespolicyproject	-1
harvardpolitics	harvardpolitics	-1
poets	poets	-1
macmillandictionary	macmillandictionary	-1
sociology	sociology.berkeley	-1
guim	i.guim.co.uk	-1
dailystar	dailystar	-1
nbclosangeles	nbclosangeles	-1
techrepublic	techrepublic	-1
osf	osf	-1
markmanson	markmanson	-1
911myths	911myths	-1
stateofworkingamerica	stateofworkingamerica	-1
muhealth	muhealth	-1
moviezhubb	moviezhubb	-1
randomcriticalanalysis	randomcriticalanalysis	-1
techtimes	techtimes	-1
legalinsurrection	legalinsurrection	-1
reference	reference	-1
lse	lse.ac.uk	-1
oldearth	oldearth	-1
evolution-institute	evolution-institute	-1
autostraddle	autostraddle	-1
ecfr	ecfr	-1
source	source.wustl	-1
aacrjournals	cebp.aacrjournals	-1
modernfarmer	modernfarmer	-1
seeker	seeker	-1
jonathanturley	jonathanturley	-1
btselem	btselem	-1
crowdstrike	crowdstrike	-1
oceanservice	oceanservice.noaa	-1
danceswithfat	danceswithfat.wordpress	-1
nationalacademies	www8.nationalacademies	-1
philosophybasics	philosophybasics	-1
middleeastmonitor	middleeastmonitor	-1
twincities	twincities	-1
inthesetimes	inthesetimes	-1
shutterstock	image.shutterstock	-1
citizensclimatelobby	citizensclimatelobby	-1
babe	babe	-1
care2	care2	-1
americananthro	perspectives.americananthro	-1
media1	media1.tenor	-1
firstamendmentcenter	firstamendmentcenter	-1
nyu	nyu	-1
yalelawjournal	yalelawjournal	-1
thetrevorproject	thetrevorproject	-1
missouri	faculty.missouri	-1
goodhousekeeping	goodhousekeeping	-1
mathworld	mathworld.wolfram	-1
truthdig	truthdig	-1
23andme	blog.23andme	-1
ozy	ozy	-1
digest	digest.bps	-1
mtholyoke	mtholyoke	-1
iwf	iwf	-1
budgetmodel	budgetmodel.wharton.upenn	-1
firstthings	firstthings	-1
nbcchicago	nbcchicago	-1
nelp	nelp	-1
int	int.nyt	-1
scottaaronson	scottaaronson	-1
eur-lex	eur-lex.europa.eu	-1
stratfor	stratfor	-1
biologicaldiversity	biologicaldiversity	-1
masstagger	masstagger	-1
esa	esa.un	-1
marieclaire	marieclaire	-1
newsobserver	newsobserver	-1
intechopen	intechopen	-1
giffords	giffords	-1
ehow	ehow	-1
mensa	mensa.ch	-1
scottishtrans	scottishtrans	-1
cga	cga.ct	-1
scienceline	scienceline	-1
kottke	kottke	-1
thehotline	thehotline	-1
jech	jech.bmj	-1
scielo	scielo.br	-1
gp	gp	-1
rewire	rewire.news	-1
thepublicdiscourse	thepublicdiscourse	-1
prochoiceactio	prochoiceactio	-1
harpersbazaar	harpersbazaar	-1
bipartisanpolicy	bipartisanpolicy	-1
doctornerdlove	doctornerdlove	-1
prntscr	prntscr	-1
outsidethebeltway	outsidethebeltway	-1
plannedparenthoodaction	plannedparenthoodaction	-1
armedwithreason	armedwithreason	-1
newsday	newsday	-1
out	out	-1
giantbomb	static.giantbomb	-1
fasebj	fasebj	-1
tesco	tesco	-1
usembassy	riyadh.usembassy	-1
phillymag	phillymag	-1
iraqbodycount	iraqbodycount	-1
jacksonville	jacksonville	-1
lib	ir.lib.uwo.ca	-1
webcitation	webcitation	-1
aclusocal	aclusocal	-1
firstpost	firstpost	-1
investor	investor.aetna	-1
vgy	vgy.me	-1
ntrs	ntrs.nasa	-1
pure	pure.uvt.nl	-1
ajpmonline	ajpmonline	-1
stanleycolors	stanleycolors	-1
chop	chop	-1
inhabitat	assets.inhabitat	-1
cbr	cbr	-1
theodysseyonline	theodysseyonline	-1
joineps	joineps.ca	-1
endofwomen	endofwomen.blogspot	-1
niskanencenter	niskanencenter	-1
security	security.blogs.cnn	-1
worlddata	worlddata.info	-1
college	college.harvard	-1
thefreelibrary	thefreelibrary	-1
metronews	metronews.ca	-1
appleinsider	appleinsider	-1
medicaid	medicaid	-1
ncdc	ncdc.noaa	-1
project-syndicate	project-syndicate	-1
c2es	c2es	-1
pennmedicine	pennmedicine	-1
smart	smart	-1
weedcontrolfreaks	weedcontrolfreaks	-1
biofortified	biofortified	-1
target	target	-1
quinnipiac	quinnipiac	-1
globalsecurity	globalsecurity	-1
warwick	blogs.warwick.ac.uk	-1
transpulseproject	transpulseproject.ca	-1
prepscholar	blog.prepscholar	-1
rd	rd	-1
ichef-1	ichef-1.bbci.co.uk	-1
miami	law.miami	-1
mcdonalds	mcdonalds	-1
seekingalpha	seekingalpha	-1
ncronline	ncronline	-1
grandin	grandin	-1
nebraskamed	nebraskamed	-1
tax	tax.ny	-1
aa	aa	-1
mrmoneymustache	mrmoneymustache	-1
acs	acs	-1
aaas	aaas	-1
drivinglaws	drivinglaws	-1
nonbinary	nonbinary	-1
tinyurl	tinyurl	-1
thrillist	thrillist	-1
pornhub	help.pornhub	-1
norml	blog.norml	-1
precaution	precaution	-1
vrg	vrg	-1
ehbonline	ehbonline	-1
cmsny	cmsny	-1
federalsafet	federalsafet	-1
potsdam	www2.potsdam	-1
cleanenergywire	cleanenergywire	-1
ecowatch	ecowatch	-1
orwell	orwell.ru	-1
bleedingheartlibertarians	bleedingheartlibertarians	-1
arizona	ag.arizona	-1
asexuality	asexuality	-1
threadreaderapp	threadreaderapp	-1
wsdot	wsdot.wa	-1
police	police	-1
cincinnati	cincinnati	-1
magiccards	magiccards.info	-1
jordanthebrobot	jordanthebrobot	-1
bfro	bfro	-1
jneurosci	jneurosci	-1
nuclearsecrecy	nuclearsecrecy	-1
learncpp	learncpp	-1
southpark	southpark.cc	-1
reddi	reddi	-1
stat	stat.fi	-1
publichealth	publichealth.arizona	-1
unfpa	unfpa	-1
gsmarena	cdn2.gsmarena	-1
freenation	freenation	-1
kztoolbox	kztoolbox	-1
facdn	d.facdn	-1
necrometrics	necrometrics	-1
whitehousehistory	whitehousehistory	-1
internationalinsurance	internationalinsurance	-1
nleomf	nleomf	-1
yalemedicine	yalemedicine	-1
rapecrisis	rapecrisis	-1
differencebetween	differencebetween	-1
theculturetrip	theculturetrip	-1
scidev	scidev	-1
goarmy	goarmy	-1
memegenerator	memegenerator	-1
economistsview	economistsview.typepad	-1
frc	frc	-1
civil-war	civil-war	-1
transhealth	transhealth.ucsf	-1
dailywritingtips	dailywritingtips	-1
archives-ouvertes	hal.archives-ouvertes.fr	-1
shorensteincenter	shorensteincenter	-1
digital	fsu.digital.flvc	-1
ascd	ascd	-1
geology	geology.utah	-1
rte	rte.ie	-1
curious	curious.astro.cornell	-1
fox2now	fox2now	-1
goodtherapy	goodtherapy	-1
needhelppayingbills	needhelppayingbills	-1
maryland	dnr.maryland	-1
veganhealth	veganhealth	-1
threefeloniesaday	threefeloniesaday	-1
dogbreedinfo	dogbreedinfo	-1
dailyanarchist	dailyanarchist	-1
bloximages	bloximages.chicago2.vip.townnews	-1
charlotteobserver	charlotteobserver	-1
bastiat	bastiat	-1
inquirer	inquirer	-1
ewg	ewg	-1
intersexequality	intersexequality	-1
ac	ac	-1
nheri	nheri	-1
me	me.me	-1
lawyers	lawyers	-1
radd	radd.it	-1
changemyview	changemyview	-1
worldfuturefund	worldfuturefund	-1
harvardlawreview	harvardlawreview	-1
yaleglobal	yaleglobal.yale	-1
nongmoproject	nongmoproject	-1
quickanddirtytips	quickanddirtytips	-1
rfa	rfa	-1
theadvocates	theadvocates	-1
halls	halls.md	-1
usc	usc	-1
bestbuy	bestbuy.ca	-1
uscode	uscode.house	-1
sefaria	sefaria	-1
twitchy	twitchy	-1
wsws	wsws	-1
e	e	-1
doingbusiness	doingbusiness	-1
wusa9	wusa9	-1
nationalaffairs	nationalaffairs	-1
publicreligion	publicreligion	-1
nationaleatingdisorders	nationaleatingdisorders	-1
groups	groups.csail.mit	-1
globalpost	globalpost	-1
americanadoptions	americanadoptions	-1
external-preview	external-preview.redd.it	-1
www-tc	www-tc.pbs	-1
eonline	eonline	-1
bitesizevegan	bitesizevegan	-1
plosmedicine	plosmedicine	-1
econofact	econofact	-1
secularprolife	secularprolife	-1
healthday	consumer.healthday	-1
twitch	twitch.tv	-1
clasp	clasp	-1
atts	atts	-1
sportsci	sportsci	-1
espnfivethirtyeight	espnfivethirtyeight.files.wordpress	-1
gofundme	gofundme	-1
dutchnews	dutchnews.nl	-1
truthout	truthout	-1
elle	elle	-1
ning	api.ning	-1
learner	learner	-1
spectrumnews	spectrumnews	-1
immigrationforum	immigrationforum	-1
thisisinsider	thisisinsider	-1
victimsofcrime	victimsofcrime	-1
priceofoil	priceofoil	-1
biomedsearch	biomedsearch	-1
powerlineblog	powerlineblog	-1
waterfootprint	waterfootprint	-1
csun	csun	-1
torontoist	torontoist	-1
lrb	lrb.co.uk	-1
clerk	clerk.house	-1
shootingtracker	shootingtracker	-1
moma	moma	-1
wto	wto	-1
stevenpinker	stevenpinker	-1
forums	forums.randi	-1
newnownext	newnownext	-1
bmjopen	bmjopen.bmj	-1
strongtowns	strongtowns	-1
iii	iii	-1
skepticalinquirer	skepticalinquirer	-1
gamerant	gamerant	-1
cnpp	cnpp.usda	-1
thebalancecareers	thebalancecareers	-1
duke	law.duke	-1
t	t	-1
curiosity	curiosity.discovery	-1
downsizin	downsizin	-1
runnersworld	runnersworld	-1
classics	classics.mit	-1
bja	bja	-1
treatmentadvocacycenter	treatmentadvocacycenter	-1
followtheintuition	followtheintuition	-1
reviewjournal	reviewjournal	-1
historyisaweapon	historyisaweapon	-1
mkorostoff	mkorostoff.github.io	-1
healthdata	healthdata	-1
cep	cep.lse.ac.uk	-1
aei-ideas	aei-ideas	-1
animalcharityevaluators	animalcharityevaluators	-1
evonomics	evonomics	-1
europarl	europarl.europa.eu	-1
marinecorpstimes	marinecorpstimes	-1
debunking911	debunking911	-1
utilitarianism	utilitarianism	-1
ancient-origins	ancient-origins	-1
word	i.word	-1
acleddata	acleddata	-1
ir	ir.la	-1
thelifeyoucansave	thelifeyoucansave	-1
aclum	aclum	-1
gaystarnews	gaystarnews	-1
prageru	prageru	-1
clarionproject	clarionproject	-1
edf	edf	-1
takingnote	takingnote.blogs.nytimes	-1
voices	voices.yahoo	-1
odmp	odmp	-1
tonic	tonic.vice	-1
adamsmith	adamsmith	-1
laweekly	laweekly	-1
singularityhub	singularityhub	-1
muslimstatistics	muslimstatistics.files.wordpress	-1
diabetes	diabetes	-1
voteview	voteview	-1
static-economist	cdn.static-economist	-1
amzn	amzn.to	-1
akns-images	akns-images.eonline	-1
anthropology	anthropology.emory	-1
nbcphiladelphia	nbcphiladelphia	-1
culturalsurvival	culturalsurvival	-1
humanrightsfirst	humanrightsfirst	-1
ic	ic.gc.ca	-1
fatherly	fatherly	-1
clevelandfed	clevelandfed	-1
globaltimes	globaltimes.cn	-1
aacap	aacap	-1
weknowmemes	weknowmemes	-1
whatever	whatever.scalzi	-1
androidauthority	androidauthority	-1
mentalhelp	mentalhelp	-1
publicseminar	publicseminar	-1
aidsmap	aidsmap	-1
thedrive	thedrive	-1
ips-dc	ips-dc	-1
casetext	casetext	-1
thegrio	thegrio	-1
quranx	quranx	-1
patents	patents.google	-1
nfpa	nfpa	-1
drgo	drgo.us	-1
mixtape	track3.mixtape.moe	-1
blackpast	blackpast	-1
abcbirds	abcbirds	-1
bankofengland	bankofengland.co.uk	-1
prisonlegalnews	prisonlegalnews	-1
economonitor	economonitor	-1
eastbayexpress	m.eastbayexpress	-1
myflorida	dos.myflorida	-1
thegreatcourses	thegreatcourses	-1
wtvr	wtvr	-1
slashfilm	slashfilm	-1
graphics	graphics.wsj	-1
shanghairanking	shanghairanking	-1
wolf-pac	wolf-pac	-1
avp	avp	-1
crmvet	crmvet	-1
climatechangenews	climatechangenews	-1
cde	cde.ca	-1
ktla	ktla	-1
bostonherald	bostonherald	-1
leagueoflegends	na.leagueoflegends	-1
bloomberglaw	news.bloomberglaw	-1
genderratic	genderratic	-1
climateactiontracker	climateactiontracker	-1
ibo	ibo	-1
hc-sc	hc-sc.gc.ca	-1
howtogeek	howtogeek	-1
adn	adn	-1
evilbible	evilbible	-1
gamerevolution	gamerevolution	-1
washingtonblade	washingtonblade	-1
objectivismforintellectuals	objectivismforintellectuals.wordpress	-1
acm	acm	-1
israelnationalnews	israelnationalnews	-1
parahumans	parahumans.wordpress	-1
dumblaws	dumblaws	-1
atomicheritage	atomicheritage	-1
informahealthcare	informahealthcare	-1
yesmagazine	yesmagazine	-1
climatecentral	climatecentral	-1
projectcensored	projectcensored	-1
ajmc	ajmc	-1
madd	madd	-1
crooksandliars	crooksandliars	-1
ocregister	ocregister	-1
whyevolutionistrue	whyevolutionistrue.wordpress	-1
substack	taibbi.substack	-1
ageconsearch	ageconsearch.umn	-1
discover	discover.hubpages	-1
safety	safety.fhwa.dot	-1
ifpri	ifpri	-1
cuny	qcc.cuny	-1
sexchangeregret	sexchangeregret	-1
theflatearthsociety	theflatearthsociety	-1
mei	mei	-1
govexec	govexec	-1
taskandpurpose	taskandpurpose	-1
wixstatic	docs.wixstatic	-1
ritholtz	ritholtz	-1
electronicintifada	electronicintifada	-1
humanrights	humanrights	-1
pitchfork	pitchfork	-1
metmuseum	metmuseum	-1
verdict	verdict.co.uk	-1
comicbook	comicbook	-1
gertstulp	gertstulp	-1
petapixel	petapixel	-1
everycrsreport	everycrsreport	-1
bostonfed	bostonfed	-1
routledge	cw.routledge	-1
transascity	transascity	-1
scholastic	mediaroom.scholastic	-1
wada-ama	wada-ama	-1
gizmag	gizmag	-1
report	report.nih	-1
datagoneodd	datagoneodd	-1
heartiste	heartiste.wordpress	-1
resources	resources.saylor	-1
chess	chess	-1
uspto	uspto	-1
usconstitution	usconstitution	-1
america	america.pink	-1
sillyolme	sillyolme.wordpress	-1
wwwn	wwwn.cdc	-1
ncdsv	ncdsv	-1
newjimcrow	newjimcrow	-1
thespruce	thespruce	-1
citypages	blogs.citypages	-1
letmegooglethat	letmegooglethat	-1
medicalmarijuana	medicalmarijuana.procon	-1
transcripts	transcripts.cnn	-1
opb	opb	-1
ypdcrime	ypdcrime	-1
netmarketshare	netmarketshare	-1
tribune	tribune	-1
afr	afr	-1
thecriminallawyer	thecriminallawyer.tumblr	-1
revisor	revisor.mn	-1
911review	911review	-1
geekwire	geekwire	-1
transcience-project	transcience-project	-1
opentextbc	opentextbc.ca	-1
thestreet	thestreet	-1
assaultweapon	assaultweapon.info	-1
fueleconomy	fueleconomy	-1
governor	governor.nc	-1
vote	vote	-1
stopbullying	stopbullying	-1
osti	osti	-1
maggiemcneill	maggiemcneill.wordpress	-1
federalregister	federalregister	-1
ebscohost	eds.a.ebscohost	-1
timeanddate	timeanddate	-1
defenseone	defenseone	-1
blueletterbible	blueletterbible	-1
indiancountrytodaymedi	indiancountrytodaymedi	-1
government	government.nl	-1
dispatch	dispatch	-1
silverchair	watermark.silverchair	-1
sizediversityandhealth	sizediversityandhealth	-1
zeit	zeit.de	-1
monthlyreview	monthlyreview	-1
universetoday	universetoday	-1
ag	ag	-1
yourtango	yourtango	-1
atlas	atlas.media.mit	-1
pressreader	pressreader	-1
maths	plus.maths	-1
tennessean	tennessean	-1
metafilter	ask.metafilter	-1
pressherald	pressherald	-1
dealbook	dealbook.nytimes	-1
scholars	scholars.law.unlv	-1
comptroller	comptroller.defense	-1
shadowproof	shadowproof	-1
euro	euro.who.int	-1
nceo	nceo	-1
nei	nei	-1
pictures	www2.pictures.zimbio	-1
responsiblelending	responsiblelending	-1
utsandiego	utsandiego	-1
etsg	etsg	-1
theknot	theknot	-1
blackdemographics	blackdemographics	-1
npiamerica	npiamerica	-1
chinadaily	chinadaily	-1
battlefields	battlefields	-1
therecoveryvillage	therecoveryvillage	-1
rcmp-grc	rcmp-grc.gc.ca	-1
covid19treatmentguidelines	covid19treatmentguidelines.nih	-1
navytimes	navytimes	-1
sott	sott	-1
meme	cdn.meme.am	-1
uproxx	uproxx	-1
reproductiverights	reproductiverights	-1
judicialwatch	judicialwatch	-1
global	global.oup	-1
laurieximenez	laurieximenez.files.wordpress	-1
icpsr	icpsr.umich	-1
healthyeating	healthyeating.sfgate	-1
gunowners	gunowners	-1
inews	inews.co.uk	-1
judiciary	judiciary	-1
omicsonline	omicsonline	-1
healthimpactnews	healthimpactnews	-1
nhl	nhl	-1
forbesimg	b-i.forbesimg	-1
pottermore	pottermore	-1
ohio	bmv.ohio	-1
feministe	feministe.us	-1
brainblogger	brainblogger	-1
as	as	-1
thepoliticalinsider	thepoliticalinsider	-1
wisegeek	wisegeek	-1
telesurenglish	telesurenglish	-1
jamestown	jamestown	-1
preprints	preprints	-1
tardis	tardis.wikia	-1
neurology	neurology	-1
admin	eda.admin.ch	-1
uschamber	uschamber	-1
copyhype	copyhype	-1
poseidon01	poseidon01.ssrn	-1
everydaynodaysoff	everydaynodaysoff	-1
rcog	rcog	-1
skepticalraptor	skepticalraptor	-1
themarysue	themarysue	-1
ingramdaily	ingramdaily	-1
cmu	cs.cmu	-1
uselectionatlas	uselectionatlas	-1
ed	ed	-1
newobserveronline	newobserveronline	-1
index	index.rsf	-1
thebulletin	thebulletin	-1
libertyfund	oll.libertyfund	-1
mainweb-v	mainweb-v.musc	-1
tvbythenumbers	tvbythenumbers.zap2it	-1
etsystatic	i.etsystatic	-1
factmyth	factmyth	-1
drawdown	drawdown	-1
neurosciencenews	neurosciencenews	-1
avmajournals	avmajournals.avma	-1
stanrock	stanrock	-1
bostonmagazine	bostonmagazine	-1
financialpost	business.financialpost	-1
yourbrainonporn	yourbrainonporn	-1
uni-muenchen	mpra.ub.uni-muenchen.de	-1
witchwind	witchwind.wordpress	-1
socialsciences	socialsciences.ucla	-1
nsarchive2	nsarchive2.gwu	-1
famousscientists	famousscientists	-1
whattoexpect	whattoexpect	-1
ss	ss	-1
thenib	thenib	-1
villainou	villainou	-1
quantamagazine	quantamagazine	-1
bodybuilding	bodybuilding	-1
video	video.pbs	-1
talkpoverty	talkpoverty	-1
joelonsoftware	joelonsoftware	-1
playstation	playstation	-1
texasobserver	texasobserver	-1
bunchecenter	bunchecenter.ucla	-1
notabug	snew.notabug.io	-1
bizpacreview	bizpacreview	-1
sportingnews	sportingnews	-1
feminspire	feminspire	-1
boysvswomen	boysvswomen	-1
courant	courant	-1
verywell	verywell	-1
ncadd	ncadd	-1
goodcall	goodcall	-1
bfy	bfy.tw	-1
aflcio	aflcio	-1
iheart	iheart	-1
fastcodesign	fastcodesign	-1
itv	itv	-1
resavr	resavr	-1
digitalmusicnews	digitalmusicnews	-1
mercyforanimals	mercyforanimals	-1
knoema	knoema	-1
explainxkcd	explainxkcd	-1
healthinsurance	healthinsurance	-1
international	international.thenewslens	-1
disabilityscoop	disabilityscoop	-1
resilience	resilience	-1
sodahead	images.sodahead	-1
electionscience	electionscience.github.io	-1
attn	attn	-1
topdocumentaryfilms	topdocumentaryfilms	-1
edwardfeser	edwardfeser.blogspot.fr	-1
brightspotcdn	ca-times.brightspotcdn	-1
telesurtv	telesurtv	-1
hslda	hslda	-1
adfontesmedia	adfontesmedia	-1
thefederalistpapers	thefederalistpapers	-1
kiro7	kiro7	-1
ksl	ksl	-1
brilliant	brilliant	-1
injuryfacts	injuryfacts.nsc	-1
vault	vault.fbi	-1
project	project.wnyc	-1
terry	terry.uga	-1
wikiart	wikiart	-1
ncfm	ncfm	-1
sunlightfoundation	sunlightfoundation	-1
ox	ox.ac.uk	-1
newsok	newsok	-1
veganoutreach	veganoutreach	-1
softpedia	news.softpedia	-1
consortiumnews	consortiumnews	-1
centerforpolitics	centerforpolitics	-1
cookpolitical	cookpolitical	-1
visionofhumanity	visionofhumanity	-1
hae	hae	-1
hoplofobia	hoplofobia.info	-1
save	save	-1
countercurrentnews	countercurrentnews	-1
madamenoire	madamenoire	-1
securitydata	securitydata.newamerica	-1
emeraldinsight	emeraldinsight	-1
tech	tech.mit	-1
nintendo	nintendo	-1
rcfp	rcfp	-1
u-s-history	u-s-history	-1
leginfo	leginfo.ca	-1
chicagomag	chicagomag	-1
economicsonline	economicsonline.co.uk	-1
homedepot	homedepot	-1
wustl	wupa.wustl	-1
aha	aha	-1
checkyourfact	checkyourfact	-1
kentucky	kentucky	-1
cgpublisher	jrci.cgpublisher	-1
pennlive	pennlive	-1
biologists	bio.biologists	-1
fjc	fjc	-1
sbtl	sbtl.tv	-1
globalpolicy	globalpolicy	-1
ymcdn	c.ymcdn	-1
uesp	uesp	-1
americablog	americablog	-1
thepatientfactor	thepatientfactor	-1
contexts	contexts	-1
kateharding	kateharding	-1
adaa	adaa	-1
mg	mg.co.za	-1
zmescience	zmescience	-1
mhanational	mhanational	-1
csicop	csicop	-1
billofrightsinstitute	billofrightsinstitute	-1
hennepin	hennepin.us	-1
macrumors	macrumors	-1
battle	us.battle	-1
nysscpa	nysscpa	-1
ancestry	ancestry	-1
edition-m	edition-m.cnn	-1
colostate	wgac.colostate	-1
edgarsnyder	edgarsnyder	-1
circumstitions	circumstitions	-1
gaylife	gaylife.about	-1
monash	monash	-1
watson	watson.brown	-1
freepress	freepress	-1
echr	echr.coe.int	-1
feinstein	feinstein.senate	-1
uspirg	uspirg	-1
virped	virped	-1
owl232	owl232	-1
populationpyramid	populationpyramid	-1
studentloanhero	studentloanhero	-1
transportation	transportation	-1
isreview	isreview	-1
enveurope	enveurope	-1
fightthenewdrug	fightthenewdrug	-1
wiki	wiki.tfes	-1
profootballtalk	profootballtalk.nbcsports	-1
star-telegram	star-telegram	-1
unep	unep	-1
gun-nuttery	gun-nuttery	-1
thumbs	thumbs.gfycat	-1
aps	aps	-1
fallacyfiles	fallacyfiles	-1
davidsongifted	davidsongifted	-1
geekparty	geekparty	-1
ciwf	ciwf	-1
queerty	queerty	-1
strikemag	strikemag	-1
soylent	soylent	-1
chalkbeat	chalkbeat	-1
cato-unbound	cato-unbound	-1
collegedata	collegedata	-1
antiwar	antiwar	-1
ice	ice	-1
gender	gender.wikia	-1
ph	ph	-1
womensenews	womensenews	-1
mason	mason.gmu	-1
ifs	ifs	-1
inis	inis.iaea	-1
queensu	queensu.ca	-1
rateyourmusic	rateyourmusic	-1
autotrader	autotrader	-1
friendlyatheist	friendlyatheist.patheos	-1
meetup	meetup	-1
writing	writing.upenn	-1
oregonlaws	oregonlaws	-1
econpapers	econpapers.repec	-1
realclearmarkets	realclearmarkets	-1
texasmonthly	texasmonthly	-1
gamefaqs	gamefaqs.gamespot	-1
racialequitytools	racialequitytools	-1
abolition	abolition.e2bn	-1
ancient	ancient.eu	-1
workplacefairness	workplacefairness	-1
discordapp	cdn.discordapp	-1
worldlifeexpectancy	worldlifeexpectancy	-1
bbcgoodfood	bbcgoodfood	-1
usmilitary	usmilitary.about	-1
6abc	6abc	-1
tate	tate	-1
scimagojr	scimagojr	-1
naturalsociety	naturalsociety	-1
stormfront	stormfront	-1
strategicstudiesinstitute	strategicstudiesinstitute.army.mil	-1
marshallbrain	marshallbrain	-1
chicagofed	chicagofed	-1
auburn	auburn	-1
merckmanuals	merckmanuals	-1
spiked-online	spiked-online	-1
obesity	obesity	-1
profezie3m	profezie3m.altervista	-1
kanzenshuu	kanzenshuu	-1
kmov	kmov	-1
mentalillnesspolicy	mentalillnesspolicy	-1
migrationobservatory	migrationobservatory.ox.ac.uk	-1
archpedi	archpedi.jam	-1
baltimore	baltimore.cbslocal	-1
datausa	datausa.io	-1
ucl	ucl.ac.uk	-1
cosmosmagazine	cosmosmagazine	-1
wamu	wamu	-1
smithsonianchannel	smithsonianchannel	-1
myjewishlearning	myjewishlearning	-1
informationclearinghouse	informationclearinghouse.info	-1
guardianlv	guardianlv	-1
publicsafety	publicsafety.gc.ca	-1
laborcenter	laborcenter.berkeley	-1
indianexpress	indianexpress	-1
wildpiginfo	wildpiginfo.msstate	-1
dazeddigital	dazeddigital	-1
giss	giss.nasa	-1
palomar	anthro.palomar	-1
chriskresser	chriskresser	-1
vgsales	vgsales.wikia	-1
aattp	aattp	-1
brilliantmaps	brilliantmaps	-1
shmoop	shmoop	-1
rockpapershotgun	rockpapershotgun	-1
eje-online	eje-online	-1
aaregistry	aaregistry	-1
pfizer	pfizer	-1
hawking	hawking	-1
hudexchange	hudexchange.info	-1
thecrimereport	thecrimereport	-1
americanhumane	americanhumane	-1
factfinder	factfinder.census	-1
makeuseof	makeuseof	-1
wikifur	en.wikifur	-1
au	au	-1
lawnewz	lawnewz	-1
5harad	5harad	-1
filer	filer.case	-1
yalescientific	yalescientific	-1
worldvision	worldvision	-1
smogon	smogon	-1
scpr	scpr	-1
mitsloan	mitsloan.mit	-1
icd	icd.who.int	-1
racp	racp	-1
mcgilldaily	mcgilldaily	-1
empirische-bildungsforschung-bmbf	empirische-bildungsforschung-bmbf.de	-1
buffalonews	buffalonews	-1
thetrumpet	thetrumpet	-1
sputniknews	sputniknews	-1
prezi	prezi	-1
breakingthescience	breakingthescience	-1
ovc	ovc	-1
navy	c7f.navy.mil	-1
moralfoundations	moralfoundations	-1
americansfortaxfairness	americansfortaxfairness	-1
thegreenpapers	thegreenpapers	-1
funnyjunk	funnyjunk	-1
citizen	citizen.co.za	-1
idaho	icdv.idaho	-1
nacwa	nacwa	-1
t-nation	t-nation	-1
oecd-nea	oecd-nea	-1
essence	essence	-1
distraction	distraction	-1
armscontrol	armscontrol	-1
shakesville	shakesville	-1
stopstreetharassment	stopstreetharassment	-1
seattle	seattle	-1
tomshardware	tomshardware	-1
oilprice	oilprice	-1
deepblue	deepblue.lib.umich	-1
wunderground	wunderground	-1
mybudget360	mybudget360	-1
overcast	overcast.fm	-1
westernjournalism	westernjournalism	-1
bernardokastrup	bernardokastrup	-1
tdpf	tdpf	-1
monmouth	monmouth	-1
nrel	nrel	-1
deptofnumbers	deptofnumbers	-1
theappeal	theappeal	-1
overpopulationisamyth	overpopulationisamyth	-1
o	o	-1
uvm	uvm	-1
aynrand	estore.aynrand	-1
politics	politics.suntimes	-1
reactiongifs	reactiongifs.us	-1
operations	operations.nfl	-1
neighborhoodscout	neighborhoodscout	-1
wayne	wayne	-1
fatherhood	fatherhood	-1
yournewswire	yournewswire	-1
lightningsafety	lightningsafety.noaa	-1
ptsd	ptsd.va	-1
magaimg	i.magaimg	-1
realtor	realtor	-1
greencarreports	greencarreports	-1
thenational	thenational.ae	-1
shape	shape	-1
qr	qr.ae	-1
movember	uk.movember	-1
topspeed	topspeed	-1
postsecondary	postsecondary	-1
king5	king5	-1
biospace	biospace	-1
vg247	vg247	-1
noaa	sos.noaa	-1
baltimorechronicle	baltimorechronicle	-1
h-cdn	sev.h-cdn.co	-1
utah	le.utah	-1
berkeleyearth	berkeleyearth	-1
consumer	consumer.ftc	-1
kaiserfamilyfoundation	kaiserfamilyfoundation.files.wordpress	-1
popsugar	popsugar	-1
howmuch	howmuch	-1
copyrightalliance	copyrightalliance	-1
fpif	fpif	-1
iapsych	iapsych	-1
socialpathology	socialpathology.blogspot	-1
mensstudies	mensstudies	-1
effectivealtruism	effectivealtruism	-1
photoshelter	cdn.c.photoshelter	-1
scholarsstrateg	scholarsstrateg	-1
in2013dollars	in2013dollars	-1
forksoverknives	forksoverknives	-1
infoproc	infoproc.blogspot	-1
rxlist	rxlist	-1
louderwithcrowder	louderwithcrowder	-1
policemag	policemag	-1
bestplaces	bestplaces	-1
xinhu	xinhu	-1
stea	stea	-1
stlpublicradio	news.stlpublicradio	-1
freedomtomarry	freedomtomarry	-1
stonewall	stonewall	-1
collegefactual	collegefactual	-1
alzheimers	alzheimers	-1
marchofdimes	marchofdimes	-1
cam	cam.ac.uk	-1
fimfiction	fimfiction	-1
modernhealthcare	modernhealthcare	-1
debates	debates	-1
worldcat	worldcat	-1
9news	9news	-1
yaqeeninstitute	yaqeeninstitute	-1
directorsblog	directorsblog.nih	-1
sexualobjectification	sexualobjectification.blogspot	-1
metabunk	metabunk	-1
populartechnology	populartechnology	-1
dels	dels.nas	-1
campusreform	campusreform	-1
thecrownestate	thecrownestate.co.uk	-1
gregmankiw	gregmankiw.blogspot	-1
equitablegrowth	equitablegrowth	-1
davidlisak	davidlisak	-1
gamergate	gamergate.me	-1
mormon	mormon	-1
qntm	qntm	-1
icrc	icrc	-1
azquotes	azquotes	-1
singlemotherguide	singlemotherguide	-1
comicsalliance	comicsalliance	-1
chapman	blogs.chapman	-1
warontherocks	warontherocks	-1
eventhubs	eventhubs	-1
oncampus	oncampus.macleans.ca	-1
suicideinfo	suicideinfo.ca	-1
narrative-collapse	narrative-collapse	-1
txstate	txstate	-1
247sports	247sports	-1
princetonspear	princetonspear	-1
beyondveg	beyondveg	-1
venezuelanalysis	venezuelanalysis	-1
insights	insights.dice	-1
intel	ark.intel	-1
apnorc	apnorc	-1
fandom	avp.fandom	-1
danariely	danariely.files.wordpress	-1
springfieldspringfield	springfieldspringfield.co.uk	-1
toysoldier	toysoldier.wordpress	-1
cairn	cairn.info	-1
spj	spj	-1
kdvr	kdvr	-1
losangeles	losangeles.cbslocal	-1
zhimg	pic1.zhimg	-1
drugpatentwatch	drugpatentwatch	-1
prettylittletattoos	prettylittletattoos.tumblr	-1
godaddy	godaddy	-1
worldstopexports	worldstopexports	-1
thepeoplehistory	thepeoplehistory	-1
publicpolicy	publicpolicy.verizon	-1
carnegiecouncil	carnegiecouncil	-1
thefeministwire	thefeministwire	-1
news24	news24	-1
michiganradio	michiganradio	-1
gavi	gavi	-1
genderbread	genderbread	-1
heraldscotland	heraldscotland	-1
emcdda	emcdda.europa.eu	-1
overwatch	overwatch.gamepedia	-1
saf	saf	-1
herculesandtheumpire	herculesandtheumpire	-1
patdollard	patdollard	-1
diversity	diversity.berkeley	-1
thevintagenews	thevintagenews	-1
ukpublicspending	ukpublicspending.co.uk	-1
visual	blog.visual.ly	-1
historyextra	historyextra	-1
mcall	mcall	-1
divorce	divorce	-1
bom	bom	-1
akc	akc	-1
jampac	jampac.us	-1
targetmap	targetmap	-1
rashiyomi	rashiyomi	-1
beyondblue	beyondblue	-1
barnesandnoble	barnesandnoble	-1
houstonchronicle	houstonchronicle	-1
yadvashem	yadvashem	-1
rightwingwatch	rightwingwatch	-1
grantland	grantland	-1
gamesindustry	gamesindustry.biz	-1
j	j	-1
kutv	kutv	-1
vogue	vogue	-1
annenbergpublicpolicycenter	annenbergpublicpolicycenter	-1
ipu	ipu	-1
surveysystem	surveysystem	-1
harkavagrant	harkavagrant	-1
eetimes	eetimes	-1
newatlas	newatlas	-1
timeline	timeline	-1
encrypted-tbn1	encrypted-tbn1.gstatic	-1
taooftomo	taooftomo	-1
nutritionix	nutritionix	-1
prevention	prevention	-1
randi	web.randi	-1
wtop	wtop	-1
publish	publish.twitter	-1
ucdenver	econ.ucdenver	-1
scirp	file.scirp	-1
humank	humank	-1
mamamia	mamamia	-1
ieeexplore	ieeexplore.ieee	-1
gu	gu	-1
annenberg	annenberg.usc	-1
stanforddaily	stanforddaily	-1
themuse	themuse	-1
uoregon	abyss.uoregon	-1
religiondispatches	religiondispatches	-1
thebluereview	thebluereview	-1
qld	qld	-1
umm	umm	-1
studybreaks	studybreaks	-1
guinnessworldrecords	guinnessworldrecords	-1
metrotimes	metrotimes	-1
fairplayforwomen	fairplayforwomen	-1
earlymoderntexts	earlymoderntexts	-1
thousandcurrents	thousandcurrents	-1
clutchmagonline	clutchmagonline	-1
earthlings	earthlings	-1
wapo	wapo.st	-1
ssir	ssir	-1
rspca	rspca	-1
thinkinghousewife	thinkinghousewife	-1
constituteproject	constituteproject	-1
app	app.leg.wa	-1
mdedge	mdedge	-1
ehealthinsurance	ehealthinsurance	-1
brainfacts	brainfacts	-1
madison	host.madison	-1
mayoclinicproceedings	mayoclinicproceedings	-1
askamathematician	askamathematician	-1
techjunkie	techjunkie	-1
news18	news18	-1
useconomy	useconomy.about	-1
caltech	nsl.caltech	-1
list25	list25	-1
bankofcanada	bankofcanada.ca	-1
newsmaven	newsmaven.io	-1
aaup	aaup	-1
thisismoney	thisismoney.co.uk	-1
mshcdn	rack.2.mshcdn	-1
circinfo	circinfo	-1
freedomofmind	freedomofmind	-1
mountvernon	mountvernon	-1
advance	advance.cornell	-1
bea	bea	-1
bp	bp	-1
gsfc	map.gsfc.nasa	-1
democraticunderground	democraticunderground	-1
kipp	kipp	-1
minnesota	minnesota.cbslocal	-1
coindesk	coindesk	-1
americanheritage	americanheritage	-1
lozierinstitute	lozierinstitute	-1
careerbuilder	careerbuilder	-1
autonews	autonews	-1
americanhistory	americanhistory.si	-1
lagrif	lagrif	-1
belfercenter	belfercenter.ksg.harvard	-1
zachmortensen	zachmortensen	-1
ndss	ndss	-1
mindbodygreen	mindbodygreen	-1
constitutionparty	constitutionparty	-1
postandcourier	postandcourier	-1
wel	wel	-1
dst	dst.dk	-1
catholi	catholi	-1
loweringthebar	loweringthebar	-1
socialistworker	socialistworker	-1
magazine	magazine.good.is	-1
thevenusproject	thevenusproject	-1
masslive	masslive	-1
stephenjaygould	stephenjaygould	-1
feministfrequency	feministfrequency	-1
sandiego	sandiego	-1
opensocietyfoundations	opensocietyfoundations	-1
criminal-law	criminal-law.freeadvice	-1
theepochtimes	theepochtimes	-1
verdantlabs	verdantlabs	-1
corporatefinanceinstitute	corporatefinanceinstitute	-1
simpletoremember	simpletoremember	-1
photius	photius	-1
encrypted-tbn2	encrypted-tbn2.gstatic	-1
fordham	legacy.fordham	-1
thebestschools	thebestschools	-1
mpaa	mpaa	-1
pop	pop	-1
openparliament	openparliament.ca	-1
varsity	nca.varsity	-1
spokesman	spokesman	-1
guides	guides.loc	-1
networkworld	networkworld	-1
volunteermatch	volunteermatch	-1
avvo	avvo	-1
paypal	paypal.me	-1
whyy	whyy	-1
desmos	desmos	-1
sapiens	sapiens	-1
destatis	destatis.de	-1
samefacts	samefacts	-1
pdfserver	pdfserver.amlaw	-1
nownys	nownys	-1
bma	bma	-1
commonslibrary	commonslibrary.parliament.uk	-1
chnm	chnm.gmu	-1
homeland	homeland.house	-1
professionals	professionals.collegeboard	-1
hyperallergic	hyperallergic	-1
crimepreventionresearchcenter	crimepreventionresearchcenter	-1
ijr	ijr	-1
phonearena	phonearena	-1
swampland	swampland.time	-1
american	american	-1
slideplayer	images.slideplayer	-1
sciencing	sciencing	-1
apmreports	apmreports	-1
chartsbin	chartsbin	-1
python	docs.python	-1
deanza	deanza	-1
hellointe	hellointe	-1
wellandgood	wellandgood	-1
lwhasten	lwhasten	-1
agcensus	agcensus.usda	-1
brandonsanderson	brandonsanderson	-1
aviationweek	aviationweek	-1
grammarist	grammarist	-1
nba	nba	-1
divorc	divorc	-1
kgw	kgw	-1
prisonstudies	prisonstudies	-1
ecs	ecs	-1
iands	iands.es	-1
ab	ab	-1
gatesnotes	gatesnotes	-1
crunchyroll	crunchyroll	-1
usgs	hvo.wr.usgs	-1
equalityhumanrights	equalityhumanrights	-1
ebayimg	i.ebayimg	-1
debt	debt	-1
d25d2506sfb94s	d25d2506sfb94s.cloudfront	-1
txdps	txdps.state.tx.us	-1
radaronline	radaronline	-1
nbcbayarea	nbcbayarea	-1
ge	ge	-1
polytechnic	faculty.polytechnic	-1
cheaperthandirt	blog.cheaperthandirt	-1
theatlas	theatlas	-1
adc	adc.bmj	-1
theenergycollective	theenergycollective	-1
treaties	treaties.un	-1
darwinawards	darwinawards	-1
hln	hln.be	-1
digitaldreamdoor	digitaldreamdoor	-1
snaptohealth	snaptohealth	-1
dell	dell	-1
asiaone	asiaone	-1
c4ss	c4ss	-1
povertyactionlab	povertyactionlab	-1
druglibrary	druglibrary	-1
ziprecruiter	ziprecruiter	-1
sacred-texts	sacred-texts	-1
stream1	stream1.gifsoup	-1
learnliberty	learnliberty	-1
store	store.usps	-1
rarediseases	rarediseases.info.nih	-1
us-cert	us-cert	-1
myfox8	myfox8	-1
afterabortion	afterabortion	-1
eatright	eatright	-1
freefromharm	freefromharm	-1
rarehistoricalphotos	rarehistoricalphotos	-1
whicdn	data3.whicdn	-1
thomas	thomas.loc	-1
effectiviology	effectiviology	-1
trulia	trulia	-1
danielpipes	danielpipes	-1
hubpages	drbj.hubpages	-1
icij	icij	-1
sciencefocus	sciencefocus	-1
clarissethorn	clarissethorn	-1
mpp	mpp	-1
imageshack	img137.imageshack.us	-1
kevinmd	kevinmd	-1
newint	newint	-1
skysports	www1.skysports	-1
ethosreview	ethosreview	-1
els-cdn	ac.els-cdn	-1
9to5mac	9to5mac	-1
gameofthrones	gameofthrones.wikia	-1
earth-policy	earth-policy	-1
hechingerreport	hechingerreport	-1
makeagif	makeagif	-1
strawpoll	strawpoll.me	-1
betterhealth	betterhealth.vic	-1
electowiki	electowiki	-1
colleges	colleges.niche	-1
scq	scq.ubc.ca	-1
developer	developer.apple	-1
kuscholarworks	kuscholarworks.ku	-1
lawdigita	lawdigita	-1
nationalpartnership	nationalpartnership	-1
electionbettingodds	electionbettingodds	-1
elpais	elpais	-1
elsevier	elsevier	-1
themuslimissue	themuslimissue.wordpress	-1
thetab	thetab	-1
christianity	christianity	-1
social	comp.social.gatech	-1
gfdl	gfdl.noaa	-1
earthsky	earthsky	-1
madinamerica	madinamerica	-1
rintintin	rintintin.colorado	-1
peterkreeft	peterkreeft	-1
indigenousfoundations	indigenousfoundations.arts.ubc.ca	-1
lawandthemultiverse	lawandthemultiverse	-1
rescue	rescue	-1
community	community.elca	-1
grossmanacademy	grossmanacademy	-1
newser	newser	-1
libguides	canberra.libguides	-1
copblock	copblock	-1
ohio-state	psy.ohio-state	-1
starbucks	starbucks	-1
guns-vs-homicide	guns-vs-homicide.github.io	-1
krgv	m.krgv	-1
anncoulter	anncoulter	-1
vdare	vdare	-1
scholarpedia	scholarpedia	-1
world-nuclear-news	world-nuclear-news	-1
loonwatch	loonwatch	-1
equalitytrust	equalitytrust	-1
catalog	catalog.purdue	-1
aec	aec	-1
acton	blog.acton	-1
vetjournal	vetjournal.it	-1
hcn	hcn	-1
medicare	medicare.ie	-1
family-law	family-law.freeadvice	-1
profam	profam	-1
nationalseedproject	nationalseedproject	-1
cultural-misandry	cultural-misandry	-1
secure	ecs.secure.force	-1
withouthotair	withouthotair	-1
survivalinternational	survivalinternational	-1
harrisinteractive	harrisinteractive	-1
homepage	homepage.smc	-1
alibaba	m.alibaba	-1
abc7ny	abc7ny	-1
leagle	leagle	-1
let	let.rug.nl	-1
indy100	indy100	-1
upjohn	upjohn	-1
addictioncenter	addictioncenter	-1
thehearttruths	thehearttruths.files.wordpress	-1
humanosphere	humanosphere	-1
gog	gog	-1
techradar	techradar	-1
nssf	nssf	-1
outdoorhub	outdoorhub	-1
izismile	img.izismile	-1
humanorigins	humanorigins.si	-1
scotsman	scotsman	-1
rhrealitycheck	rhrealitycheck	-1
jsexmed	jsm.jsexmed	-1
thefix	thefix	-1
cpr	cpr	-1
nakedcapitalism	nakedcapitalism	-1
kansas	kansas	-1
andrewleigh	andrewleigh	-1
asiafoundation	asiafoundation	-1
boxedwaterisbetter	boxedwaterisbetter	-1
patreon	patreon	-1
lapatilla	lapatilla	-1
townandcountrymag	townandcountrymag	-1
osgata	osgata	-1
caffeineinformer	caffeineinformer	-1
neatorama	static.neatorama	-1
hiv	hiv	-1
minitab	blog.minitab	-1
qwantz	qwantz	-1
thepostmillennial	thepostmillennial	-1
thrivenotes	thrivenotes	-1
corpus	corpus.quran	-1
civilliberty	civilliberty.about	-1
andrewsullivan	dish.andrewsullivan	-1
sjsu	sjsu	-1
laist	laist	-1
ar500armor	ar500armor	-1
vetstreet	vetstreet	-1
upmc	upmc	-1
globalfirepower	globalfirepower	-1
wesleyan	droyer.web.wesleyan	-1
hubspot	cdn2.hubspot	-1
amnh	amnh	-1
digitalspy	digitalspy	-1
tnellen	tnellen	-1
spglobal	spglobal	-1
preposterousuniverse	preposterousuniverse	-1
ottawacitizen	ottawacitizen	-1
bmcpsychiatry	bmcpsychiatry.biomedcentral	-1
healthcentral	healthcentral	-1
solar-center	solar-center.stanford	-1
nikkei	asia.nikkei	-1
scottsantens	scottsantens	-1
falkvinge	falkvinge	-1
vaers	vaers.hhs	-1
delaware	icis.corp.delaware	-1
justdetention	justdetention	-1
richarddawkins	richarddawkins	-1
brooklyn	acc6.its.brooklyn.cuny	-1
ditext	ditext	-1
pioneer	pioneer	-1
childrenshospital	childrenshospital	-1
webappa	webappa.cdc	-1
vegetariantimes	vegetariantimes	-1
nysed	op.nysed	-1
jamieoliver	jamieoliver	-1
tenor	c.tenor	-1
maristpoll	maristpoll.marist	-1
wsbtv	wsbtv	-1
jewfaq	jewfaq	-1
aier	aier	-1
autoblog	autoblog	-1
wwf	wwf.de	-1
humanevents	humanevents	-1
transplant	optn.transplant.hrsa	-1
demographics	demographics.virginia	-1
r-word	r-word	-1
business-humanrights	business-humanrights	-1
accesstoinsight	accesstoinsight	-1
engagedscholarship	engagedscholarship.csuohio	-1
adoptio	adoptio	-1
www-rohan	www-rohan.sdsu	-1
danielmiessler	danielmiessler	-1
pando	pando	-1
reddithelp	reddithelp	-1
votingrights	votingrights.news21	-1
eewc	eewc	-1
playoverwatch	playoverwatch	-1
blackenterprise	blackenterprise	-1
the-american-interest	the-american-interest	-1
fritolay	fritolay	-1
ga	ga	-1
ftalphaville	ftalphaville.ft	-1
cfpub	cfpub.epa	-1
media-cache-ak0	media-cache-ak0.pinimg	-1
nationsreportcard	nationsreportcard	-1
unwatch	unwatch	-1
thingofthings	thingofthings.wordpress	-1
businessdictionary	businessdictionary	-1
palmbeachpost	palmbeachpost	-1
revelist	revelist	-1
rameznaam	rameznaam	-1
delish	delish	-1
ScoreVoting	ScoreVoting	-1
wcpo	wcpo	-1
gamelengths	gamelengths	-1
trustvote	trustvote	-1
iifym	iifym	-1
islam101	islam101	-1
rentjungle	rentjungle	-1
cironline	cironline	-1
abclocal	abclocal.go	-1
controlled-demolition	controlled-demolition	-1
gamapserver	gamapserver.who.int	-1
fdrlibrary	docs.fdrlibrary.marist	-1
afer	afer	-1
americanscientist	americanscientist	-1
ucsd	bt.ucsd	-1
republic	republic	-1
vibe	vibe	-1
worldstarhiphop	worldstarhiphop	-1
patft	patft.uspto	-1
asnjournals	cjasn.asnjournals	-1
ecfsapi	ecfsapi.fcc	-1
physlink	physlink	-1
toptenz	toptenz	-1
utilitydive	utilitydive	-1
churchofjesuschrist	churchofjesuschrist	-1
dissentmagazine	dissentmagazine	-1
skeptic	skeptic	-1
nmaahc	nmaahc.si	-1
trid	trid.trb	-1
usma	usma	-1
badassdigest	badassdigest	-1
pride-flags	pride-flags.deviantart	-1
returnofkings	returnofkings	-1
cancercouncil	cancercouncil	-1
itsgoingdown	itsgoingdown	-1
legionathletics	legionathletics	-1
energyfromthorium	energyfromthorium	-1
flibe-energy	flibe-energy	-1
nextshark	nextshark	-1
suite	suite.io	-1
msf	msf	-1
sfu	sfu.ca	-1
spacex	spacex	-1
eatocracy	eatocracy.cnn	-1
the-orbit	the-orbit	-1
hdnux	ww3.hdnux	-1
deathandtaxesmag	deathandtaxesmag	-1
therecord	therecord	-1
walmartimages	i5.walmartimages	-1
1in6	1in6	-1
endocrine-abstracts	endocrine-abstracts	-1
capitalresearch	capitalresearch	-1
foodispower	foodispower	-1
healthblog	healthblog.uofmhealth	-1
confex	apha.confex	-1
raisetheminimumwage	raisetheminimumwage	-1
cpsc	cpsc	-1
gunmemorial	gunmemorial	-1
deloitte	www2.deloitte	-1
dutchrapporteur	dutchrapporteur.nl	-1
nss	nss	-1
blockchain	blockchain.info	-1
simplejustice	blog.simplejustice.us	-1
gstatic	t0.gstatic	-1
freedomforuminstitute	freedomforuminstitute	-1
cbsistatic	cbsnews1.cbsistatic	-1
futureofchildren	futureofchildren	-1
ala	ala	-1
ncregister	m.ncregister	-1
nonprofitquarterly	nonprofitquarterly	-1
iol	iol.co.za	-1
equalitynow	equalitynow	-1
media-cache-ec0	media-cache-ec0.pinimg	-1
cs	cs	-1
stakeholders	stakeholders.o	-1
defacingcurrency	defacingcurrency.files.wordpress	-1
immunize	immunize	-1
animenew	animenew	-1
statcounter	gs.statcounter	-1
mckinleyirvin	mckinleyirvin	-1
hightimes	hightimes	-1
mentalhealthamerica	mentalhealthamerica	-1
coop	geo.coop	-1
tiktok	vm.tiktok	-1
darpa	darpa.mil	-1
libjournal	libjournal.uncg	-1
learnersdictionary	learnersdictionary	-1
tvguide	tvguide	-1
theatlanticcities	theatlanticcities	-1
policingequity	policingequity	-1
acas	acas	-1
kxan	kxan	-1
heartland	blog.heartland	-1
civilrightsproject	civilrightsproject.ucla	-1
insightcrime	insightcrime	-1
blacknerdproblems	blacknerdproblems	-1
nsarchive	nsarchive.gwu	-1
girlpowermarketing	girlpowermarketing	-1
wqad	wqad	-1
unstats	unstats.un	-1
galact	galact	-1
kiva	kiva	-1
hofstra	hofstra	-1
fotoforensics	fotoforensics	-1
springerpub	connect.springerpub	-1
theecologist	theecologist	-1
random	random	-1
consumeraffairs	consumeraffairs	-1
movies	uk.movies.yahoo	-1
stuartmcmillen	stuartmcmillen	-1
mil	au.af.mil	-1
active	active	-1
climatenexus	climatenexus	-1
drjengunter	drjengunter.wordpress	-1
peacemaker	peacemaker.un	-1
hrweb	hrweb.mit	-1
nbcdfw	nbcdfw	-1
cbn	cbn	-1
aphis	aphis.usda	-1
dailytech	dailytech	-1
jjmccullough	jjmccullough	-1
devex	devex	-1
hrlibrary	hrlibrary.umn	-1
citynews	citynews.ca	-1
minus	i.minus	-1
someecards	cdn.someecards	-1
explorable	explorable	-1
thorntons-law	thorntons-law.co.uk	-1
gr-assets	i.gr-assets	-1
hartford	uhaweb.hartford	-1
edutopia	edutopia	-1
bossip	bossip	-1
grammarly	grammarly	-1
mrctv	mrctv	-1
bluelight	bluelight	-1
csp	csp	-1
press	press.umich	-1
econweb	econweb.ucsd	-1
marvelcinematicuniverse	marvelcinematicuniverse.wikia	-1
craigslist	sfbay.craigslist	-1
media2	media2.fdncms	-1
Ancestry	Ancestry	-1
marxist	marxist	-1
calorielab	calorielab	-1
tqn	0.tqn	-1
bignam	bignam	-1
theness	theness	-1
scouting	scouting	-1
pegc	pegc.us	-1
thepsychologist	thepsychologist.bps	-1
nato	nato.int	-1
everybodysolar	everybodysolar	-1
powermag	powermag	-1
ps	ps	-1
truthorfiction	truthorfiction	-1
bitchmedia	bitchmedia	-1
aaha	aaha	-1
thenewprogressive	thenewprogressive	-1
properalism	properalism.blogspot	-1
smith-wesson	smith-wesson	-1
bl	bl.uk	-1
m	m	-1
foo	foo	-1
encrypted-tbn3	encrypted-tbn3.gstatic	-1
bethematch	bethematch	-1
therationalmale	therationalmale	-1
islandia	islandia.law.yale	-1
dbsalliance	dbsalliance	-1
dollarsandsense	dollarsandsense.sg	-1
photographyisnotacrime	photographyisnotacrime	-1
angryharry	angryharry	-1
jstage	jstage.jst.go.jp	-1
ipcc-wg2	ipcc-wg2	-1
uslegal	courts.uslegal	-1
boards	boards.4chan	-1
weeklysift	weeklysift	-1
mindingthecampus	mindingthecampus	-1
iata	iata	-1
thenewcivilrightsmovement	thenewcivilrightsmovement	-1
goingfaster	goingfaster	-1
buffalo	buffalo	-1
androidpolice	androidpolice	-1
welt	welt.de	-1
maine	maine	-1
freethinker	freethinker.co.uk	-1
pajiba	pajiba	-1
codinghorror	blog.codinghorror	-1
mass	mass	-1
henrikkleven	henrikkleven	-1
soapboxie	soapboxie	-1
philochristos	philochristos.blogspot	-1
stephenhicks	stephenhicks	-1
mediaradar	mediaradar	-1
vera	vera	-1
electorama	wiki.electorama	-1
southernnevadahealthdistrict	covid.southernnevadahealthdistrict	-1
archinte	archinte.jam	-1
legaldictionary	legaldictionary	-1
santafenewmexican	santafenewmexican	-1
portlandoregon	portlandoregon	-1
bcg	bcg	-1
oneangrygamer	oneangrygamer	-1
nhchc	nhchc	-1
babyreference	babyreference	-1
westegg	westegg	-1
static1	static1.srcdn	-1
newdualism	newdualism	-1
adaptt	adaptt	-1
newmalecontraception	newmalecontraception	-1
chainsawsuit	chainsawsuit	-1
transformdrugs	transformdrugs	-1
ncsc	ncsc	-1
indiatoday	indiatoday.intoday.in	-1
972mag	972mag	-1
whole-dog-journal	whole-dog-journal	-1
dnainfo	dnainfo	-1
alz	alz	-1
corpwatch	corpwatch	-1
biblica	biblica	-1
freedomainradio	cdn.media.freedomainradio	-1
4chan	4chan	-1
whyislam	whyislam	-1
trutv	trutv	-1
humanparts	humanparts.medium	-1
thumbor	thumbor.forbes	-1
rockinst	rockinst	-1
torontolife	torontolife	-1
activistpost	activistpost	-1
gawkerassets	img.gawkerassets	-1
consilium	consilium.europa.eu	-1
khou	khou	-1
abrahamlincolnonline	abrahamlincolnonline	-1
carnegieendowment	carnegieendowment	-1
www-nytimes	www-nytimes	-1
11alive	11alive	-1
vhemt	vhemt	-1
secure-media	secure-media.collegeboard	-1
academicjournals	academicjournals	-1
ireport	ireport.cnn	-1
thecaucus	thecaucus.blogs.nytimes	-1
justfactsdaily	justfactsdaily	-1
apartmentlist	apartmentlist	-1
haveibeenpwned	haveibeenpwned	-1
federal-budget	federal-budget.insid	-1
nationalobserver	nationalobserver	-1
partners	partners.nytimes	-1
veganuary	veganuary	-1
jpeds	jpeds	-1
minecraft	minecraft.gamepedia	-1
blizzard	us.blizzard	-1
channelnewsasia	channelnewsasia	-1
periscopic	terror.periscopic	-1
nsfwyoutube	nsfwyoutube	-1
nhm	nhm.ac.uk	-1
over-blog-kiwi	img.over-blog-kiwi	-1
fansided	fansided	-1
habitat	habitat.ca	-1
stjude	stjude	-1
elsiehui	elsiehui	-1
consumerfinance	consumerfinance	-1
chessbase	en.chessbase	-1
collider	collider	-1
greatist	greatist	-1
gifted	gifted.uconn	-1
worldvaluessurvey	worldvaluessurvey	-1
justjared	cdn01.cdn.justjared	-1
calorieking	calorieking	-1
edsource	edsource	-1
ems1	ems1	-1
komonews	komonews	-1
mensjournal	mensjournal	-1
origins	origins.osu	-1
chicagobusiness	chicagobusiness	-1
andrewbostom	andrewbostom	-1
economicoutlook	bilbo.economicoutlook	-1
dailynews	dailynews	-1
efile	efile	-1
crin	crin	-1
emory	law.emory	-1
firearmsandliberty	firearmsandliberty	-1
mynorthwest	mynorthwest	-1
ccrjustice	ccrjustice	-1
faa	faa	-1
cedro-uva	cedro-uva	-1
nme	nme	-1
prwatch	prwatch	-1
gunsandammo	gunsandammo	-1
heatst	heatst	-1
crisis	crisis	-1
daveramsey	daveramsey	-1
sipri	sipri	-1
zippia	zippia	-1
andrewgelman	andrewgelman	-1
quorum	quorum.us	-1
edx	edx	-1
kare11	kare11	-1
naacpldf	naacpldf	-1
discogs	discogs	-1
politicalticker	politicalticker.blogs.cnn	-1
fox6now	fox6now	-1
nsopw	nsopw	-1
usaspending	datalab.usaspending	-1
skyandtelescope	skyandtelescope	-1
globalinnovationindex	globalinnovationindex	-1
downtrend	downtrend	-1
acslaw	acslaw	-1
redcross	redcross	-1
img	img.nbc	-1
cartercenter	cartercenter	-1
hiddenincatours	hiddenincatours	-1
openknowledge	openknowledge.worldbank	-1
expertlaw	expertlaw	-1
openpsychometrics	openpsychometrics	-1
billionbibles	billionbibles	-1
interglacial	interglacial	-1
anepigone	anepigone.blogspot	-1
hyperphysics	hyperphysics.phy-astr.gsu	-1
aft	aft	-1
tec	tec	-1
nationalmemo	nationalmemo	-1
nass	nass.usda	-1
bandcamp	bandcamp	-1
peteforamerica	peteforamerica	-1
statmodeling	statmodeling.stat.columbia	-1
ne	ne.su.se	-1
anarchism	anarchism.pageabode	-1
havocscope	havocscope	-1
nbc	nbc	-1
astronomy	astronomy	-1
tn	tn	-1
etonline	etonline	-1
scu	scu	-1
oxfordre	oxfordre	-1
mindyourdecisions	mindyourdecisions	-1
chipotle	ir.chipotle	-1
americanaffairsjournal	americanaffairsjournal	-1
wondermark	wondermark	-1
hulu	hulu	-1
mpoweruk	mpoweruk	-1
sparkpeople	sparkpeople	-1
amsciepub	amsciepub	-1
costco	www2.costco	-1
goodrx	goodrx	-1
chicagonow	chicagonow	-1
tierneylab	tierneylab.blogs.nytimes	-1
survivalafterdeath	survivalafterdeath.info	-1
nlrb	nlrb	-1
frontporchrepublic	frontporchrepublic	-1
trucks	trucks	-1
rtings	rtings	-1
sole-jole	sole-jole	-1
dominionmovement	dominionmovement	-1
asirt	asirt	-1
tafp	tafp	-1
subsidytracker	subsidytracker.goodjobsfirst	-1
expatica	expatica	-1
moneychimp	moneychimp	-1
expatistan	expatistan	-1
philosophyfaculty	philosophyfaculty.ucsd	-1
thesmokinggun	thesmokinggun	-1
opdv	opdv.ny	-1
degruyter	degruyter	-1
ecology	ecology	-1
michellemalkin	michellemalkin	-1
grubstreet	grubstreet	-1
exploringthemind	exploringthemind	-1
nagc	nagc	-1
indianapublicmedia	indianapublicmedia	-1
glamourmagazine	glamourmagazine.co.uk	-1
obamacarefacts	obamacarefacts	-1
nationalparalegal	nationalparalegal	-1
americansforprosperity	americansforprosperity	-1
westernjournal	westernjournal	-1
dresdencodak	dresdencodak	-1
immigration	immigration.procon	-1
philosophyexperiments	philosophyexperiments	-1
joemygod	joemygod.blogspot	-1
aihw	aihw	-1
thriveglobal	thriveglobal	-1
surgeongeneral	surgeongeneral	-1
d20pfsrd	d20pfsrd	-1
thehealthyhomeeconomist	thehealthyhomeeconomist	-1
owlcation	owlcation	-1
deadiversion	deadiversion.usdoj	-1
anad	anad	-1
transgenderlaw	transgenderlaw	-1
bangordailynews	bangordailynews	-1
cars	cars	-1
measuringworth	measuringworth	-1
cnnpressroom	cnnpressroom.blogs.cnn	-1
idea	idea.int	-1
cjcj	cjcj	-1
spin	spin	-1
highprogrammer	highprogrammer	-1
arb	arb.ca	-1
bepress	works.bepress	-1
eluniversal	archivo.eluniversal	-1
historycentral	historycentral	-1
tobaccofreekids	tobaccofreekids	-1
bechdeltest	bechdeltest	-1
ndtv	ndtv	-1
etsy	etsy	-1
meta	meta.ath0	-1
beforeitsnews	beforeitsnews	-1
cityobservatory	cityobservatory	-1
civilwarcauses	civilwarcauses	-1
classroom	classroom.synonym	-1
www4	www4.uwm	-1
fidelity	fidelity	-1
natureworldnews	natureworldnews	-1
colorofcrime	colorofcrime	-1
bradfordtaxinstitute	bradfordtaxinstitute	-1
venganza	venganza	-1
cntraveler	cntraveler	-1
judithcurry	judithcurry	-1
plsonline	plsonline.eku	-1
4plebs	img.4plebs	-1
catbox	files.catbox.moe	-1
sportsmediawatch	sportsmediawatch	-1
researchbriefings	researchbriefings.files.parliament.uk	-1
redditmetrics	redditmetrics	-1
hrblock	hrblock	-1
quanthockey	quanthockey	-1
cyberbullying	cyberbullying	-1
multivax	multivax	-1
good	good.is	-1
cnbcfm	sc.cnbcfm	-1
asam	asam	-1
interactioninstitute	interactioninstitute	-1
motortrend	motortrend	-1
drugfreeworld	drugfreeworld	-1
stories	stories.avvo	-1
washingtonian	washingtonian	-1
airforcetimes	archive.airforcetimes	-1
steemit	steemit	-1
mymodernmet	mymodernmet	-1
gigaom	gigaom	-1
brandeis	brandeis	-1
arktimes	arktimes	-1
thesatanictemple	thesatanictemple	-1
usccr	usccr	-1
pewstates	pewstates	-1
pamelageller	pamelageller	-1
humanprogress	humanprogress	-1
popcenter	popcenter	-1
books	books.nap	-1
americanrhetoric	americanrhetoric	-1
greatveganathletes	greatveganathletes	-1
wweek	wweek	-1
volvocars	new.volvocars	-1
reddituploads	i.reddituploads	-1
bradley	bradley	-1
ulwaluko	ulwaluko.co.za	-1
educationdata	educationdata	-1
galegroup	ic.galegroup	-1
whio	whio	-1
pcgamesn	pcgamesn	-1
level3	blog.level3	-1
permutationofninjas	permutationofninjas	-1
bicycling	bicycling	-1
1drv	1drv.ms	-1
uspsoig	uspsoig	-1
mnstate	web.mnstate	-1
mining	mining	-1
rspb	rspb	-1
desiringgod	desiringgod	-1
claimsjournal	claimsjournal	-1
miaminewtimes	miaminewtimes	-1
evolution-outreach	evolution-outreach.biomedcentral	-1
marriage	marriage.uslegal	-1
thenews	thenews	-1
metapedia	en.metapedia	-1
explosm	explosm	-1
historytoday	historytoday	-1
zerotothree	zerotothree	-1
hcup-us	hcup-us.ahrq	-1
cpusa	cpusa	-1
seatguru	seatguru	-1
adblockplus	adblockplus	-1
cdiac	cdiac.ornl	-1
vaccinepapers	vaccinepapers	-1
ssbwiki	ssbwiki	-1
ebony	ebony	-1
niche	niche	-1
abuaminaelias	abuaminaelias	-1
understandingprejudice	understandingprejudice	-1
transgendertrend	transgendertrend	-1
irena	irena	-1
fangraphs	tht.fangraphs	-1
strangenotions	strangenotions	-1
vgchartz	vgchartz	-1
link	link.gale	-1
refworld	refworld	-1
topendsports	topendsports	-1
righteousmind	righteousmind	-1
fema	fema	-1
distractify	news.distractify	-1
nakedsecurity	nakedsecurity.sophos	-1
oddschecker	oddschecker	-1
agric	agric.wa	-1
dummies	dummies	-1
moga	moga.mo	-1
publicmind	publicmind.fdu	-1
thehomegunsmith	thehomegunsmith	-1
nationalreport	nationalreport	-1
powerliftingwatch	powerliftingwatch	-1
michaelshermer	michaelshermer	-1
physoc	physoc	-1
policyinnovations	policyinnovations	-1
republicreport	republicreport	-1
baseball-reference	baseball-reference	-1
nyagv	nyagv	-1
chegg	chegg	-1
cpa	cpa.ca	-1
timebusinessblog	timebusinessblog.files.wordpress	-1
greenbiz	greenbiz	-1
ewtn	ewtn	-1
canberra	aerg.canberra	-1
hdot	hdot	-1
regjeringen	regjeringen.no	-1
bostonfairhousing	bostonfairhousing	-1
eurostat	appsso.eurostat.ec.europa.eu	-1
the-sun	the-sun	-1
fsis	fsis.usda	-1
uh	uh	-1
hurriyetdailynews	hurriyetdailynews	-1
ihr	ihr	-1
gladwell	gladwell	-1
fourmilab	fourmilab.ch	-1
gvpedia	gvpedia	-1
s	s	-1
lambdalegal	lambdalegal	-1
prostitution	prostitution.procon	-1
svt	svt.se	-1
ascopubs	jco.ascopubs	-1
ourfuture	ourfuture	-1
yaledailynews	yaledailynews	-1
bitnation	bitnation.co	-1
fox59	fox59	-1
bikeleague	bikeleague	-1
neatoday	neatoday	-1
changetip	changetip	-1
mnsu	sbs.mnsu	-1
21stcentech	21stcentech	-1
usitc	usitc	-1
comicvine	comicvine	-1
timothy-judge	timothy-judge	-1
religionfacts	religionfacts	-1
freerangekids	freerangekids	-1
norc	gss.norc	-1
ctj	ctj	-1
job-openings	job-openings.monster	-1
thechart	thechart.blogs.cnn	-1
apologeticspress	apologeticspress	-1
wftv	wftv	-1
gis	gis.cdc	-1
guernicamag	guernicamag	-1
zolarenergy	zolarenergy	-1
csom	csom	-1
islamicsupremecouncil	islamicsupremecouncil	-1
china	china	-1
freedom-dividend	freedom-dividend	-1
johanneskopf	johanneskopf.de	-1
avert	avert	-1
coha	coha	-1
details	details	-1
conceptart	conceptart	-1
politicalparity	politicalparity	-1
embryo	embryo.asu	-1
policeviolencereport	policeviolencereport	-1
atlasobscura	atlasobscura	-1
onthemedia	onthemedia	-1
bicyclinglife	bicyclinglife	-1
anonymousus	anonymousus	-1
manboobz	manboobz	-1
ikea	ikea	-1
frbatlanta	frbatlanta	-1
bjui-journals	bjui-journals.onlinelibrary.wiley	-1
fmcsa	cms.fmcsa.dot	-1
adoption	adoption	-1
iris	iris.ucl.ac.uk	-1
tolkiengateway	tolkiengateway	-1
chicagounbound	chicagounbound.uchicago	-1
feynmanlectures	feynmanlectures.caltech	-1
centerforinquiry	ns2.centerforinquiry	-1
childrensrights	childrensrights	-1
rgl	rgl.faa	-1
petiscos	petiscos	-1
alllaw	alllaw	-1
digilander	digilander.libero.it	-1
steinhardt	steinhardt.nyu	-1
labor	labor.ny	-1
12news	12news	-1
reminddit	reminddit	-1
d1wqtxts1xzle7	d1wqtxts1xzle7.cloudfront	-1
ageofconsent	ageofconsent	-1
nomachetejuggling	nomachetejuggling	-1
vegan	vegan	-1
covid19	covid19.nih	-1
thegwpf	thegwpf	-1
houseofnames	houseofnames	-1
opsgear	opsgear	-1
