subreddit	stance
climateskeptics	anti
skeptic	anti
climatechange	pro
climate	pro
science	neut
ClimateCrisis	pro
CarbonCapture	pro
Sustainability	pro
Climate_Discussion	pro
EnviroAction	pro
CarbonTax	pro
ClimateActionPlan	pro
ClimateOffensive	pro
Environment	pro
climate_science	pro
GlobalWarming	pro
Global_Warming	pro
Green	pro
EcoInternet	pro
energy	neut
climatology	pro
conservation	pro
deep_ecology	pro
Drought	pro
earthscience	pro
ecology	pro
ecologycenter	pro
ecorestoration	pro
enviroment	pro
Environmental_Science	pro
globalclimatechange	pro
greenplanet	pro
rainforest	pro
restoration_ecology	pro
sustainable_energy	pro
ccfunding	pro
climategate	anti
GreenNewIdeas	pro
ClimatePreparation	pro
350	pro
EarthDisaster	pro
climatesecurity	pro
CollapseSurvival	pro
climate_activism	pro
ClimateSplattergate	anti
RealClimateSkeptics	anti
DebateAClimateSkeptic	anti
trueclimateskeptics	anti
climatskeptics	anti
climatedebate	anti
climatepredicts	anti
climatedebate2	anti
climatecmv	neut
ClimateSkepticScience	anti
ClimateSkepticWatch	anti
AgentsOfDoubt	anti
ClimateSkepticNews	anti
climatestasis	anti
ThunbergSyndrome	anti
ClimateChangeCancer	anti
GlobalWarmingisBunk	anti
GWB	anti
350ppm	pro
WorldClimate	pro
ClimateMobilization	pro
Republican	neut
republicans	neut
askaconservative	neut
Conservative	neut
conservatives	neut
TrueConservativism	neut
AskTrumpSupporters	neut
